ts EE l a j I	illegal
z O x z aa	illegal
z ii l OO zh i	illegal
ts o m A ts O	legal
j I k oo ch i	legal
ch' aa b EE z A	illegal
ch' O k' O dz I	illegal
s aa x I j ee	illegal
ts' e n o sh A	illegal
z o m II ch e	illegal
s E w A sh ii	illegal
z aa b a ch O	illegal
dz E t zh ee	illegal
ch' i w AA sh OO	legal
ch' A n I ch oo	legal
ts a d AA ts E	legal
s I k' aa j aa	illegal
zh oo l i j I	legal
z ee tL i z e	illegal
ts' i t' O ch' o	illegal
ts O y EE dz A	legal
ts aa n OO s A	legal
ch' O t' a dz E	illegal
s AA k o j I	illegal
ts A x EE dz OO	legal
sh ii t E z e	illegal
ch' O tL O sh ee	legal
ch' oo l e z o	illegal
s o k' aa ts e	legal
sh e t AA ts i	illegal
sh aa X I ts e	illegal
z aa x oo dz O	illegal
ch o d ee ch' a	legal
z O k' I s oo	illegal
zh O t' OO sh aa	legal
dz O dl i dz oo	legal
z oo dl a sh aa	illegal
ch' A m a z EE	illegal
ch' ii n ii ch oo	legal
ts' II k' II ts II	legal
dz II y II ch E	illegal
ch O g E z O	illegal
zh OO w sh EE	legal
j A tL EE ts' o	illegal
dz AA w EE zh o	illegal
ts E t' AA dz II	legal
j OO k AA ts' AA	illegal
ch i L I zh oo	legal
ts' OO tL' i ch ii	illegal
s O k E ts' ee	legal
zh o m z O	illegal
ch' aa tL' oo dz I	illegal
ts e k E dz o	legal
j E tL ii ch' aa	legal
ch EE X ee z i	illegal
sh OO y OO ts OO	illegal
ts' oo x oo z OO	illegal
zh ii m a j OO	legal
sh aa dl E s E	illegal
j oo t' O ch aa	legal
zh O l EE ch O	legal
sh AA tL i z EE	illegal
ch e tL AA z II	illegal
z OO dl I dz E	illegal
s E t' e dz a	legal
ts' oo X II ts O	legal
ts EE n ee ts' E	legal
z i L E ts' OO	illegal
s e k' O ch e	illegal
s e tL' OO ts' EE	legal
dz oo t a z OO	illegal
ch' e d oo ch' o	legal
ts' O h AA ch' oo	illegal
z II gh A sh E	illegal
ts AA t' e ts E	legal
sh E d II sh ii	legal
z i t a sh o	illegal
s AA X i z oo	illegal
dz O x ee sh a	illegal
ts II x ee ch' E	illegal
ch EE k' e s EE	illegal
dz OO l e sh II	illegal
ts ii w aa ch II	illegal
ch' aa X aa sh OO	legal
z aa w I j e	illegal
ts II X ts' oo	legal
dz EE b I j i	illegal
zh OO m E zh EE	legal
dz aa m A ch' E	illegal
zh i tL O ch' A	legal
j I h AA ts' o	illegal
j e h OO dz II	illegal
z o X I ch' A	illegal
j I dl zh E	legal
s E n j AA	illegal
z OO X EE s AA	illegal
sh O t II z AA	illegal
ch' AA g ch AA	legal
ch I m O s AA	illegal
dz A x ee ts ee	legal
zh ee w OO s II	illegal
ts' I m O s e	legal
z oo w o ch' i	illegal
ch O l II dz I	illegal
sh O gh O ts' OO	illegal
sh oo tL O sh ee	legal
z EE gh e z i	illegal
zh I L s AA	illegal
ts' i k O sh EE	illegal
sh a k i ts' aa	illegal
ts E m ii ch' E	illegal
zh oo b ii zh o	legal
ts oo tL' ch' II	illegal
ts ee tL' j I	illegal
s A l O j E	illegal
dz OO h ii j o	illegal
ch' II k z i	illegal
z O k' EE ch' I	illegal
z II X zh O	illegal
dz oo L aa z II	illegal
z A k' aa ch' E	illegal
z o g e ch ee	illegal
zh A w A ts' I	illegal
j AA g o ts' a	illegal
z oo w OO z e	illegal
zh ee dl aa ch EE	legal
ts e x AA z ee	illegal
zh o X E zh AA	legal
ch AA n O ts' oo	illegal
ch' ii g A z i	illegal
ch O w e z EE	illegal
dz i t' EE sh oo	illegal
ch' ii y oo ts i	illegal
ch aa d a ts ee	illegal
dz II t ii ch a	illegal
s aa tL dz ee	legal
ch' aa m E ts' ii	illegal
s II tL I ts' a	legal
z a l ts' a	illegal
sh aa k II sh E	legal
ch aa k' E z A	illegal
s o y E z a	illegal
z OO gh i sh OO	illegal
j ii k OO z I	illegal
j O b I ch' OO	legal
s aa X O j A	illegal
sh A tL ii z e	illegal
ch' i t e zh ee	legal
zh I n A ch e	legal
ts EE tL ii zh AA	illegal
ch' II n II ts EE	illegal
z ee x I ch OO	illegal
ch' I L ii sh e	legal
ts' ii y OO zh II	illegal
ch i h oo ch' II	legal
j AA g a ch aa	legal
s OO l I zh o	illegal
sh ee m I z ii	illegal
ch o k' AA ts' E	illegal
j e g o dz A	illegal
dz e m EE dz I	legal
ts oo h I dz A	legal
z o b II z AA	illegal
z O tL' I sh O	illegal
z E L I ts AA	illegal
zh OO k ii j a	legal
ts EE t' oo dz a	legal
zh aa gh O zh AA	legal
sh I gh II ts ee	illegal
ch i gh I j OO	legal
ts' EE m oo dz oo	legal
zh e dl ee j E	legal
ch' e w ii s ee	illegal
j oo n O zh o	legal
ch' o L zh OO	legal
j I dl aa z OO	illegal
s o t e z ee	illegal
z E L e zh o	illegal
dz e k' aa ts ii	legal
j I w oo ts' EE	illegal
dz ee x A z o	illegal
ch' ee n AA j ii	legal
dz A l E zh i	illegal
ch' a tL' ii ch a	legal
zh O g oo ch' oo	legal
s ii tL a j aa	illegal
ch' O g A z ee	illegal
ch ee k oo ts' oo	illegal
sh O d ts' ee	illegal
ts' E g EE ts' OO	legal
ch' I g aa dz I	illegal
ch oo x I s EE	illegal
zh I n II ch' o	legal
ch' O tL aa sh I	legal
ts' ii L ts' EE	legal
j AA t AA ch oo	legal
sh O k o zh ee	legal
z OO dl O j ee	illegal
sh aa k II z O	illegal
j EE X OO ch' EE	legal
dz II d EE ts ii	legal
ts ee X AA sh EE	illegal
sh e tL' aa ch' oo	legal
ts i dl a ts' oo	legal
s aa m A ch' E	illegal
j I g I dz aa	illegal
z E t ee ch' ee	illegal
s o X O dz oo	legal
z oo t' O j o	illegal
z OO m i ch AA	illegal
s ee k' i z ii	illegal
sh A t oo dz ii	illegal
z AA gh i ts' oo	illegal
dz AA x AA sh e	illegal
ch' O n a sh OO	legal
ch' aa k' O ts' ee	illegal
sh E gh ee ts' ii	illegal
ch A x i ch' EE	legal
ch OO tL AA ch aa	legal
ts' ii t z AA	illegal
z e l sh oo	illegal
z OO tL o ts a	illegal
dz E tL' OO j E	illegal
ch' AA X a j oo	legal
ch aa g I s o	illegal
zh AA x ii ch oo	legal
ts oo dl O ts' i	legal
dz ii y ii j aa	illegal
zh EE x EE sh e	legal
s II d o dz OO	legal
z ee y E s A	illegal
sh oo dl o ts II	illegal
zh a gh oo z a	illegal
ch' o tL' i dz ii	illegal
z AA k' o z a	illegal
z ee w E ts E	illegal
dz AA d A sh O	illegal
ts EE tL' oo z A	illegal
j aa y AA sh II	legal
ch aa k' A ch' O	legal
sh OO w a z ii	illegal
s e y aa z A	illegal
ts I g ii ch oo	illegal
ch AA k' OO z E	illegal
zh oo tL' a ch A	legal
sh E d oo j o	legal
j i x oo ch ee	legal
j ee dl EE z OO	illegal
ts I dl A z a	illegal
j I k ch E	legal
j O t' o ch AA	legal
s O gh aa z I	illegal
zh i k' A ts' e	illegal
dz OO y oo ts' I	legal
ts o n II zh I	illegal
ch' a d O z O	illegal
dz O m e z ee	illegal
ch ii n ee z OO	illegal
ts o n EE z o	illegal
z a k ii z AA	illegal
ts' aa k' ee ts' A	legal
zh I tL aa z A	illegal
ch' O t oo z E	illegal
j oo L A s EE	illegal
ts o b AA zh e	illegal
sh ee l i sh aa	legal
j aa n e ch' a	legal
ch e gh sh i	legal
s EE x a z o	illegal
ts AA n II zh OO	illegal
zh oo g I zh OO	legal
dz EE X o sh ii	illegal
z i tL' zh EE	illegal
z ii m e j a	illegal
zh o b EE zh ii	legal
ts' ii w AA sh i	illegal
ts' A k ee sh i	illegal
j ee m o ts ii	illegal
s EE L O zh ii	illegal
ch' O b E j aa	legal
z ii x oo j ee	illegal
s A gh sh II	illegal
z I h aa s aa	illegal
dz II d A z OO	illegal
dz e n e dz AA	legal
z EE m ii s O	illegal
s E n ii ch' aa	illegal
ts' A w II z aa	illegal
j O gh E dz o	illegal
z ii n OO dz E	illegal
z i t o s I	illegal
ch EE tL I ts' OO	illegal
ts e y OO z a	illegal
z i k zh o	illegal
ch II n E z a	illegal
z I k' O ch AA	illegal
z e L ch' ii	illegal
dz O gh e z ii	illegal
z e d ii ch' EE	illegal
zh O m O s ee	illegal
zh I n OO ts E	illegal
ch' oo L aa ts' EE	illegal
dz O y EE dz O	legal
sh O m A s EE	illegal
z I tL' OO ts' oo	illegal
z EE k' EE sh i	illegal
ch' II k AA dz oo	illegal
dz OO h EE ch A	illegal
ts EE n a ts' o	legal
z e tL' AA zh ee	illegal
ch II dl aa zh ii	legal
ts' a k' EE zh AA	illegal
sh OO L sh oo	legal
dz O t I sh i	illegal
j E n a sh aa	legal
zh EE L sh E	legal
j aa L oo dz o	illegal
j a gh o ts EE	illegal
ch OO dl II zh i	legal
ch' o tL E s ee	illegal
ch EE X I sh AA	legal
ts' E n oo ts AA	legal
sh e tL sh ee	legal
ts' a b e j i	illegal
dz oo g sh I	illegal
ch oo tL' e z oo	illegal
sh A dl AA z II	illegal
zh E k ts' OO	illegal
ts i L I dz AA	legal
ch A tL' zh I	legal
z AA k' OO sh OO	illegal
ch o l aa dz EE	illegal
zh A X dz o	illegal
z O l aa ts a	illegal
dz E k aa z o	illegal
j II t II zh oo	legal
dz I d i zh II	illegal
dz O d O j OO	illegal
z i d ii sh i	illegal
s aa tL' EE dz I	legal
z A m EE z O	illegal
ch' ii l II ch o	legal
z oo k' ii s ee	illegal
ch aa dl a ch E	legal
ts oo tL' E ts AA	legal
ch' OO k' A zh I	legal
ts' E b EE j AA	illegal
s ee tL AA ch' aa	illegal
ch' e t' A sh EE	legal
ts' I m EE ch' II	illegal
sh AA t aa zh I	legal
dz e t e z o	illegal
ch' a k OO j ii	legal
s a d O dz E	legal
z O d OO ch' E	illegal
ch o g a sh o	legal
z A tL ii ch ii	illegal
j I dl ee z oo	illegal
ch ee tL aa z oo	illegal
z II h oo ts e	illegal
z OO L II sh ee	illegal
dz oo g ee z a	illegal
j ii L EE sh o	legal
sh A k EE z EE	illegal
ch' E t' EE ts o	illegal
j o h ee z oo	illegal
s OO h A ch i	illegal
zh O g e sh I	legal
sh ii w II z II	illegal
ch' O g E ts OO	illegal
s i tL' aa ts' I	legal
sh ee n ii ts' aa	illegal
ch' I m a ts' ii	illegal
j aa w O ts' E	illegal
ch' i L i z ii	illegal
s O t' z E	illegal
dz OO w ts I	legal
ts' aa gh A s I	legal
dz oo x s oo	legal
ts' a gh ts o	legal
z A m z AA	illegal
z ee l zh I	illegal
j oo gh O zh E	legal
ts' o l A z AA	illegal
z II t II zh a	illegal
z E n i ts a	illegal
s ii k ts oo	legal
j EE h i dz e	illegal
zh E dl II j O	legal
ch' E h e dz O	illegal
s e X I z II	illegal
ts' i t' AA ch a	illegal
s AA dl aa zh AA	illegal
ts' i l aa z ii	illegal
dz oo h ii ts e	legal
j O b O ch' OO	legal
zh o tL' oo z a	illegal
z i x EE ch' A	illegal
ts' E m OO sh I	illegal
dz a h oo j E	illegal
z E m e ts EE	illegal
ch ii t EE z I	illegal
z i y aa s EE	illegal
z O L ee s EE	illegal
j II t' i zh ee	legal
z aa t' EE ts aa	illegal
dz aa g a dz E	legal
z aa tL' OO z O	illegal
sh O k' o dz o	illegal
ts AA x AA sh ee	illegal
j ii tL' e ts a	illegal
ch OO b I ch' E	legal
sh oo k' O dz A	illegal
ts A b i j oo	illegal
j OO k' e s A	illegal
dz ee w oo z o	illegal
ts a k' O ts AA	legal
z e h o sh ii	illegal
sh a b a z II	illegal
j i dl i z E	illegal
zh AA b EE ch II	legal
ts aa L ch II	illegal
z E k' oo ts i	illegal
ts I b A z AA	illegal
j aa y a sh AA	legal
dz ee k A ts ii	legal
zh a dl II ch I	legal
j aa gh aa dz a	illegal
ts II X o dz AA	legal
ch o h a z A	illegal
z O g AA ts O	illegal
ts OO gh A ts e	legal
ts i t E ch aa	illegal
sh a k sh O	legal
ch' a k' I ch AA	legal
j I x AA z E	illegal
s o x OO sh OO	illegal
sh AA g I ts aa	illegal
dz i t z o	illegal
zh E x I ts o	illegal
sh OO l AA z I	illegal
z II m o j E	illegal
sh E t' AA j aa	legal
j ii y aa sh O	legal
j O g oo dz OO	illegal
ts AA d ii ts' E	legal
z aa L o sh E	illegal
z oo m EE dz ii	illegal
sh a w o ch II	legal
j e w E z OO	illegal
z A w E dz E	illegal
ts II d OO ch' AA	illegal
dz oo t' aa z I	illegal
z aa y oo s EE	illegal
dz AA tL o z oo	illegal
z a k' a ch' i	illegal
s a t' e ts O	legal
sh e k' E zh AA	legal
z I n j I	illegal
dz II tL E j ee	illegal
ts ii L A z EE	illegal
z O l AA dz oo	illegal
ch' oo tL ee ts a	illegal
z O gh oo ch' aa	illegal
z O x a ch' a	illegal
ch' a h ch E	legal
zh ee n ii ch' a	legal
j ii L OO ch' E	legal
j oo X I ts' O	illegal
j oo X ch ee	legal
j oo y O z OO	illegal
ch EE y O ts ee	illegal
z EE b e dz oo	illegal
zh OO h ee dz I	illegal
s i n AA z AA	illegal
ts ii y OO ts ii	legal
ch I n EE z e	illegal
sh aa dl E z ee	illegal
j O b II ch' e	legal
sh A tL' II ts' AA	illegal
ch' ii t' OO ts I	illegal
ch' II x zh AA	legal
zh ee dl i s ii	illegal
z E w z ee	illegal
j II gh EE ts i	illegal
ts' E t ch ii	illegal
dz e k' O j I	illegal
dz ee b A ts' O	legal
s AA m OO dz e	legal
ch' oo m EE sh AA	legal
ch A h ee ts EE	illegal
zh o x a zh OO	legal
sh a b oo z OO	illegal
sh ee d o ts' o	illegal
ch' a tL' ee ch' II	legal
z i d II z oo	illegal
ch' II h O ts' OO	illegal
s I n i z A	illegal
ts' EE w oo sh ii	illegal
j II tL o ch' e	legal
z AA dl ch I	illegal
z a w E s aa	illegal
j E g i ts' II	illegal
ch' A n OO s AA	illegal
ch' AA dl e zh AA	legal
ts' AA x o ch' EE	illegal
ch aa X aa sh I	legal
sh oo dl OO sh o	legal
zh OO t' I j I	legal
ch I x AA zh oo	legal
ts' oo k ii j AA	illegal
s A x OO ts ii	legal
sh OO L ee sh a	legal
ts' E t A dz oo	legal
ts aa h OO z o	illegal
ch' ee n ch' E	legal
ts' E t OO z i	illegal
dz AA gh a ts' A	legal
j oo l A ts' E	illegal
ts e n o z aa	illegal
j e m aa zh a	legal
ts' o k ts' EE	legal
j o w II ts' o	illegal
ch' OO w i s O	illegal
z oo d E zh AA	illegal
j E h o ch' ee	legal
ch' i m OO sh A	legal
ch O h EE z E	illegal
z ii t' I dz a	illegal
z ii t I s a	illegal
ts' oo L z I	illegal
ch' II L AA s aa	illegal
ts o x i zh a	illegal
zh A k I z I	illegal
z OO t' E dz ii	illegal
z ii x ii z I	illegal
dz E k' OO zh EE	illegal
j aa dl ii dz A	illegal
s aa x II ts E	legal
z ii x o ts' aa	illegal
z II d ee z O	illegal
ts' e tL' a zh I	illegal
ts' AA n ii zh a	illegal
dz a w i s oo	legal
ts a w I z OO	illegal
ts ii d zh AA	illegal
z aa tL I z II	illegal
j II X A ts' AA	illegal
ch' AA tL II ts II	illegal
ts' A k' o zh i	illegal
ch AA tL' ts oo	illegal
s ee tL II ts O	legal
s o tL AA ts' e	legal
z I tL' a sh i	illegal
zh i k oo j ee	legal
z e x A z EE	illegal
ch' OO t ii ch i	legal
sh E x E ch E	legal
z A L o dz A	illegal
j II t OO ch' a	legal
sh O l ch O	legal
ts O dl ee ch II	illegal
j ii m o ts aa	illegal
j a t' e ts' AA	illegal
zh E k zh O	legal
zh ii gh II ch' ee	legal
ts' E tL' OO j AA	illegal
z I m AA j O	illegal
ch' o n EE sh o	legal
sh O n O ch' aa	legal
sh A L EE ts' II	illegal
s AA X e z AA	illegal
zh O y O s a	illegal
z E gh a ts II	illegal
s i b oo dz E	legal
j e b I zh OO	legal
zh EE m E z aa	illegal
dz i X II dz II	legal
z OO l OO s AA	illegal
dz aa X A j oo	illegal
dz EE L OO sh a	illegal
ch e gh a s oo	illegal
j a w O z a	illegal
sh II gh ee sh oo	legal
sh AA x EE ch EE	legal
s A w AA ch' A	illegal
ts' aa x z ee	illegal
sh ii X sh AA	legal
s AA h O sh i	illegal
ch' A m I z EE	illegal
ts ii L A s ee	legal
ts' AA l ii sh EE	illegal
z E tL a j OO	illegal
s AA m e z aa	illegal
z E gh ch' aa	illegal
z ii n O ch' o	illegal
z oo m j E	illegal
ch I b oo sh EE	legal
ch' e k e z o	illegal
s ee tL' EE s a	legal
ts ii L o zh o	illegal
ch' O k' EE ch ii	legal
ch e y ee zh ee	legal
ch' ii h o dz I	illegal
zh ee tL E z oo	illegal
zh O k' E z i	illegal
dz E y zh OO	illegal
z o k E sh a	illegal
z ee k II ts' ii	illegal
ts' I dl ii z e	illegal
z I dl OO z ii	illegal
ts oo tL A ts E	legal
ch' o dl E zh oo	legal
zh ii m ii j EE	legal
ts ii k' ee ch' aa	illegal
s AA k ee ts' II	legal
s A l aa ch OO	illegal
z A l ii ch OO	illegal
z aa h ii ts a	illegal
ts A gh EE z ee	illegal
ts O k aa dz EE	legal
ch a k aa ts EE	illegal
ts' e n aa z I	illegal
ts' o l II ts' E	legal
ts' EE L a z ee	illegal
j o x ee sh o	legal
j aa t' E dz I	illegal
ch O y ee sh EE	legal
sh AA m O j EE	legal
zh i w EE ch' i	legal
zh a n O s ii	illegal
dz AA tL OO ts oo	legal
z ii t' AA ch ee	illegal
zh oo t' II ts OO	illegal
z O h ee ts ee	illegal
ch e tL ee sh a	legal
ch i dl dz ii	illegal
ts' oo t II z I	illegal
s i h e z e	illegal
zh II k' ee j AA	legal
dz A x AA j E	illegal
s E tL' ii ch OO	illegal
ts aa h a j a	illegal
j oo dl ee z o	illegal
ts a t aa ch' a	illegal
sh AA tL' i ch E	legal
dz o m e zh a	illegal
ch' O gh ee zh II	legal
ts' aa h E ts E	legal
zh A dl O ch' O	legal
sh aa y I ts AA	illegal
z I m EE dz a	illegal
ch o tL' a s ii	illegal
s I t' ii ts i	legal
j e k AA z o	illegal
z AA l dz EE	illegal
ts ii x a ch A	illegal
z II g I ch II	illegal
dz aa n A zh a	illegal
z e tL' zh I	illegal
ch' EE d o s oo	illegal
j AA d a ts a	illegal
ch EE w EE ch ee	legal
j i t ts' aa	illegal
j ee w oo ts aa	illegal
zh O y ch o	legal
ch' aa k' AA z E	illegal
j EE b o z aa	illegal
zh ee k' EE sh AA	legal
s OO tL OO zh o	illegal
ts' a X ch oo	illegal
ch i h aa dz oo	illegal
ch' e n ch' EE	legal
sh oo t' A dz E	illegal
zh ii x aa sh o	legal
ts' i w sh a	illegal
s o tL OO sh aa	illegal
z ii b a dz ii	illegal
z E d OO ts' e	illegal
z OO b II ch' aa	illegal
ch' aa g O j oo	legal
dz e y o s ii	legal
j I gh II ch' oo	legal
ts' I n a z I	illegal
ts i t a ch' aa	illegal
z ii L I dz E	illegal
ts i tL' ii j oo	illegal
ch' e tL dz oo	illegal
ts' i tL' A z OO	illegal
ch' i w II ts' E	illegal
ch a m OO dz e	illegal
z O k I ch' e	illegal
ts' i y EE z oo	illegal
z EE t' ts' II	illegal
zh E L e z e	illegal
ch OO k' ee j EE	legal
zh aa n e ch' a	legal
ts II n ii ch a	illegal
ch I x ch A	legal
ch' AA k' ts' II	illegal
ts' aa X a s EE	legal
ch' o b I dz aa	illegal
ts' ee g EE zh oo	illegal
zh EE g e zh AA	legal
ts aa X OO s EE	legal
z aa L OO z II	illegal
s II g I ch aa	illegal
j O t' oo j i	legal
j AA t' s oo	illegal
sh OO tL' ch OO	legal
ch AA g E sh O	legal
ts' ee L ii sh a	illegal
ch E m EE z i	illegal
z oo tL' ee zh AA	illegal
dz OO d OO zh II	illegal
zh I m ii zh i	legal
j II y AA z oo	illegal
sh O t I j OO	legal
ts' aa n II ts' e	legal
s o k' a j E	illegal
ch' A b e ts aa	illegal
z ee d oo ch' aa	illegal
ch' ee gh j I	legal
dz EE y oo ch' II	illegal
ts O dl i sh I	illegal
ts' a k E ch' E	illegal
sh EE tL OO dz II	illegal
z I t' oo dz aa	illegal
z e y ii z O	illegal
ts' II gh o ts' A	legal
s A h II zh ee	illegal
dz o n ii ts a	legal
z a x I s AA	illegal
s ee n EE s II	legal
s I g O z a	illegal
z E h II z ee	illegal
s a t ii s OO	legal
j o g EE ch' O	legal
z ee t a ts ii	illegal
dz AA x oo ch e	illegal
sh aa m ts ii	illegal
sh aa d E z AA	illegal
z aa y i ch' AA	illegal
ts' a l e s o	legal
s i k' OO j II	illegal
zh AA d I sh E	legal
dz I k e ts' ee	legal
sh I y o z E	illegal
sh E k O s I	illegal
s E t OO j O	illegal
s ee tL aa ch A	illegal
sh o h I ch A	legal
ch' I y ch' i	legal
sh ii w O zh e	legal
z ii tL' I z a	illegal
ts E t' i zh I	illegal
ch' oo X aa zh OO	legal
z II b o ch OO	illegal
z AA k' z I	illegal
ch I l I zh ii	legal
ts OO k' e ts' II	legal
ch' EE x A ts' OO	illegal
ch' i t O ts' O	illegal
dz aa tL A ch oo	illegal
z AA b OO ts ii	illegal
z ii tL oo dz i	illegal
z o n z ee	illegal
j ee L a ch' OO	legal
sh AA tL EE ch' oo	legal
ch OO l I z AA	illegal
dz II k' i ts e	legal
z oo n oo ts' a	illegal
ch' ee t z EE	illegal
s EE l o dz OO	legal
ch' I n E ts' i	illegal
ch' EE tL A j aa	legal
z o k ii j a	illegal
s AA y OO ch I	illegal
sh II n O s ii	illegal
j a k II ts e	illegal
ch a d a zh I	legal
ts EE m EE ch oo	illegal
z OO t A ch' EE	illegal
z EE dl a ts' ii	illegal
j ee L A j a	legal
ts' I d o ts o	legal
ts ee gh EE ts' ii	legal
z EE t I ts' a	illegal
ts ii b oo z OO	illegal
ch i gh o z i	illegal
s A t' e ts' e	legal
s a L ts I	legal
ts' EE dl oo sh EE	illegal
ts OO dl zh ee	illegal
ts a tL A z e	illegal
j ii X oo ch' AA	legal
j o b EE ch II	legal
sh ee L I ts' AA	illegal
ts o x AA ts' E	legal
ts' E l I s AA	legal
ts' oo b zh ii	illegal
ts II b II sh O	illegal
ch' aa w A ch' EE	legal
zh EE g ch EE	legal
s oo g dz I	legal
ts o n aa zh a	illegal
ch O w oo ch aa	legal
z AA gh ii dz ii	illegal
sh OO l E sh oo	legal
ch' o t OO z O	illegal
ch' A gh OO zh ee	legal
z e k' II ch e	illegal
z O l ee ch E	illegal
z AA h ii j ii	illegal
dz EE x a z aa	illegal
ch' e t aa zh I	legal
z e k' aa z II	illegal
z AA x s I	illegal
ts' o m aa ts' OO	legal
ch EE tL I zh I	legal
z o dl ee ch ii	illegal
ch' ii k oo z E	illegal
ts oo g E sh II	illegal
dz I h OO z aa	illegal
j o tL' OO ch aa	legal
ch ee X e sh i	legal
ts' a k' O ts a	legal
ch A t' OO ts AA	illegal
ch' o gh i j I	legal
s O m EE ch O	illegal
s ee h EE sh I	illegal
j I g O j O	legal
s o k' A zh o	illegal
z II tL' e ts' e	illegal
ts' EE m E dz O	legal
z O l e sh o	illegal
ts O x oo dz e	legal
ch ii y II z I	illegal
ts' AA d E z ii	illegal
ch ee h II ts' a	illegal
ts' I t' OO sh oo	illegal
zh aa x ii s a	illegal
z oo y O ch E	illegal
ch' ee k aa z i	illegal
zh E n ch' ee	legal
zh I tL' AA s EE	illegal
sh II t AA z ee	illegal
ts' ee k O zh E	illegal
sh AA dl II ts' OO	illegal
zh i y II z II	illegal
sh ii tL' dz A	illegal
z AA t' II zh o	illegal
zh aa n O zh oo	legal
j A n EE ch' ee	legal
ch AA dl II z ee	illegal
zh OO X O z e	illegal
s ii g ee s oo	legal
j O l II ts' e	illegal
ts a m a ts' a	legal
sh EE m EE z o	illegal
s AA h E zh II	illegal
z oo k EE s a	illegal
ts EE w AA dz e	legal
s aa gh O z I	illegal
j o w AA zh E	legal
dz II tL j i	illegal
ch' A L OO ch oo	legal
z II X A ts' o	illegal
ts E X ii z E	illegal
ch' A d sh AA	legal
ch ee l o ts i	illegal
ts' II k' EE ch' a	illegal
s oo g oo ts' a	legal
ch' II l sh e	legal
s a d oo z i	illegal
s I m ee ts AA	legal
dz o g A dz E	legal
z E d EE s AA	illegal
zh II x a ch AA	legal
ch O k' O ch I	legal
dz II tL oo zh I	illegal
ts aa y aa dz ee	legal
ch e g oo s I	illegal
j OO d o z oo	illegal
sh aa l O j I	legal
zh aa k' ii z OO	illegal
zh aa L ii z I	illegal
ch' EE k' ee j ii	legal
dz E L aa j i	illegal
zh II m zh EE	legal
dz i y aa j E	illegal
sh ii t' aa ts oo	illegal
ts' II tL' e ch' aa	illegal
ts' o h AA ch' OO	illegal
zh ee t EE zh i	legal
ch O w e ch AA	legal
z ee gh A z i	illegal
ts' A m O z A	illegal
zh O tL' O s EE	illegal
j a t oo ch' II	legal
z a gh a z I	illegal
j II k' EE sh o	legal
s o t' a s o	legal
dz oo y AA s EE	legal
dz oo dl e dz AA	legal
z ee m ii ts e	illegal
zh E m O sh oo	legal
j e m OO zh EE	legal
zh i X EE zh ii	legal
s e k' ii j I	illegal
s o l ee z o	illegal
zh OO tL' O z I	illegal
s OO l OO j EE	illegal
ch' A l O z O	illegal
zh II w o j II	legal
s AA b ts' AA	legal
dz o k' E s O	legal
dz II x e dz O	legal
ts O l e zh AA	illegal
sh oo X E ts o	illegal
z aa n EE dz aa	illegal
ts' ee g a zh E	illegal
ts' I gh ee ch' ee	illegal
ch' A t' ts A	illegal
ch E k' o zh a	legal
j e X aa j II	legal
sh O L a s A	illegal
zh o k oo j oo	legal
ch aa k oo z ii	illegal
ch' EE gh s A	illegal
s a w i j E	illegal
zh aa L EE sh oo	legal
s e x s AA	legal
j ii l II dz AA	illegal
j oo l I s e	illegal
dz aa k z oo	illegal
z aa g o j OO	illegal
j E t ts EE	illegal
zh aa g z AA	illegal
z O y ee sh O	illegal
sh i L o z EE	illegal
z ee t i zh OO	illegal
s a d A ch' E	illegal
ch EE w dz I	illegal
sh O g a ts a	illegal
ts' II tL' aa ch a	illegal
zh e w a ts A	illegal
s oo k' dz EE	legal
s II x o dz e	legal
zh o X aa j aa	legal
dz oo l oo j i	illegal
ch' ee L EE ts' e	illegal
ch oo L ee zh II	legal
j EE b e j oo	legal
ch' AA k a j O	legal
s O k z A	illegal
zh ii y ee ts' A	illegal
z AA m oo z AA	illegal
zh E dl II s e	illegal
ch aa d oo ch AA	legal
dz i m oo ts' o	legal
s OO k' e ch II	illegal
s i b I ts' I	legal
dz i m o sh i	illegal
z aa tL' e ts O	illegal
dz ee m AA ts E	legal
j A m II ch' o	legal
ch' A gh ts' o	illegal
s ii w A ch' EE	illegal
ch E g aa z i	illegal
j AA dl I zh I	legal
zh oo x s e	illegal
sh ee t j EE	legal
s i X EE j OO	illegal
z A h o ch' O	illegal
z aa X EE z OO	illegal
z oo b z i	illegal
j i d OO s E	illegal
ch' A k' a dz e	illegal
z a y oo z AA	illegal
dz ee h ch' i	illegal
sh E t A z ee	illegal
ch' A k' o z A	illegal
ch' E X ts' I	illegal
z ee y e ch' ee	illegal
sh EE X EE ch ii	legal
j oo tL' E s e	illegal
j I tL' i ch' i	legal
j OO X ee s E	illegal
ts EE l e zh o	illegal
z a d oo zh I	illegal
z E k' aa z OO	illegal
dz aa h E z E	illegal
ts' O y a zh aa	illegal
dz oo dl oo ch aa	illegal
ts ii l ee ts' e	legal
dz II d ee ts I	legal
ch' E k' ee ch AA	legal
z a y E j aa	illegal
ts i dl II ts O	legal
j ii g z aa	illegal
ch i X A dz e	illegal
ch' oo X oo z a	illegal
zh E L O s II	illegal
z A tL OO ts A	illegal
ts O k' e sh OO	illegal
zh i b oo zh EE	legal
ch' oo dl dz AA	illegal
ts' aa X A z oo	illegal
z EE gh ee ch' O	illegal
ts' e y ii z O	illegal
dz aa l II sh A	illegal
zh aa n E zh O	legal
zh ee l OO ch' EE	legal
j A t' O dz e	illegal
s ii gh z a	illegal
ts' o X o ts i	legal
ch' oo tL AA z O	illegal
ts a y i ts o	legal
ts EE l O sh AA	illegal
z I w a s aa	illegal
dz E w EE sh e	illegal
s a n ee dz E	legal
ch' o t ii sh ii	legal
zh I t A ch' ee	legal
s EE h o zh EE	illegal
ch' OO t s EE	illegal
z ee y ii s E	illegal
zh aa m z I	illegal
ts ii k' A zh A	illegal
ts' O g II z OO	illegal
z AA dl ee dz OO	illegal
z A k' e ch' a	illegal
ts ee d OO z EE	illegal
z e gh ee dz EE	illegal
ts E d OO ts o	legal
zh ee t O dz A	illegal
z ee tL a sh e	illegal
s AA y i ch' OO	illegal
s EE y I z ii	illegal
j i t ii z a	illegal
ts aa h aa dz a	legal
z EE k' i sh o	illegal
zh aa x ii s OO	illegal
ch' aa n e z O	illegal
dz ee tL' e dz i	legal
z O h I ts' i	illegal
ts' II k' a z I	illegal
j EE y E s ii	illegal
ch oo l z ii	illegal
ch' e d E zh a	legal
z AA y e z I	illegal
dz e x oo ts' E	legal
z aa tL' O z O	illegal
zh ii t oo z EE	illegal
s i t' OO ch i	illegal
zh ee w AA ch i	legal
zh aa d sh E	legal
ts E gh oo z e	illegal
ts EE tL oo s oo	legal
s o m AA s oo	legal
dz EE n o sh ii	illegal
s i t II j A	illegal
dz I x OO sh II	illegal
ch ii X AA ts' ii	illegal
ts e x dz O	legal
z e m o zh ii	illegal
ts' II b o ts O	legal
dz EE tL' E ch ii	illegal
ts' aa L s O	legal
dz AA l ch' a	illegal
j I t zh O	legal
z a d zh II	illegal
ts A d ch AA	illegal
ch' aa dl s A	illegal
zh A y OO ch' ii	legal
ts OO L ii ts e	legal
ch' oo l II j e	legal
zh i b A s II	illegal
z I y O ch A	illegal
dz ee tL OO ts' ii	legal
ch EE k' E s i	illegal
s OO X I ts o	legal
dz a t' a s O	legal
ts' a g O ts' oo	legal
j e tL' ii z e	illegal
ts' aa tL' aa s i	legal
ch' a k o z ee	illegal
j O g oo sh ee	legal
s AA y o j EE	illegal
sh I t' aa z I	illegal
sh E y II sh i	legal
j AA tL' ii s O	illegal
dz O h OO j EE	illegal
z O l OO sh o	illegal
s I tL' ts I	legal
ch AA dl E j OO	legal
dz e X O ts' a	legal
ts' EE t' OO ts' ee	legal
ch' E w aa s OO	illegal
sh O t ch ii	legal
ch' A h s EE	illegal
dz i L O zh OO	illegal
ch' ee b oo ts EE	illegal
ch I w aa ch' II	legal
dz I t aa z A	illegal
s i tL' ee ch EE	illegal
ts OO h aa ch a	illegal
j I y OO z O	illegal
ts' OO t' z A	illegal
zh I m O s A	illegal
ch' oo b O ts EE	illegal
ch AA k O zh o	legal
z a m EE ch O	illegal
j O d A j II	legal
ch' aa dl o dz E	illegal
zh ii l A z A	illegal
sh ii tL' o ch' aa	legal
s oo h O sh o	illegal
s O t II ch I	illegal
sh II t' i dz AA	illegal
dz aa tL zh EE	illegal
j o l ee ch' E	legal
z O m z EE	illegal
ch E n ts' II	illegal
s ee h aa dz e	legal
ts' i dl j oo	illegal
ch' EE t AA sh aa	legal
zh ii k' o s II	illegal
sh aa m sh i	legal
s O L OO ch E	illegal
zh II b a dz EE	illegal
zh aa tL' ee s AA	illegal
z I h AA sh ee	illegal
s aa y a sh ee	illegal
s ii l O ch ee	illegal
z ii n E sh ee	illegal
sh oo L zh i	legal
zh E tL' ii z e	illegal
z ii t' s A	illegal
ts OO dl E ts' EE	legal
s E gh AA ch a	illegal
s E x I ch oo	illegal
j OO t ts' o	illegal
zh OO gh i z E	illegal
j E w e ch' ee	legal
z AA n ii zh O	illegal
z oo tL' a zh ee	illegal
zh A w EE ts' ii	illegal
z E w i ch EE	illegal
z E gh sh o	illegal
ts' I X II sh EE	illegal
ts' a k ts' AA	legal
z OO x oo zh EE	illegal
dz oo w ch E	illegal
ts oo h A zh II	illegal
dz aa dl E zh OO	illegal
ts II t ts oo	legal
ch' a d O dz o	illegal
j i h oo sh a	legal
s I h ee s ii	legal
zh I n i ch' e	legal
zh e k E sh ii	legal
j i tL' O j o	legal
sh i t' A j E	legal
dz E tL aa ch AA	illegal
dz o g II j E	illegal
j i X I j AA	legal
ts E tL' EE j OO	illegal
z oo b E zh II	illegal
ch' ii k e ts' O	illegal
ch' o g II s aa	illegal
dz I L EE s i	legal
sh aa y ee z ii	illegal
z O dl OO ch OO	illegal
j e m ii z i	illegal
z OO tL' OO ch' ii	illegal
ch' oo t' ii s e	illegal
ts' a w aa dz ee	legal
sh E y ch e	legal
s II m OO z aa	illegal
ch aa b ch A	legal
z a d EE ts ii	illegal
ch' I gh E dz ii	illegal
j A tL' e ts' II	illegal
ch ii k I zh II	legal
zh A x E ch' o	legal
ch OO d A dz ii	illegal
ts A tL' E ch A	illegal
ch' ii gh EE ch' AA	legal
z EE t a s i	illegal
zh ee k' O dz I	illegal
ch i gh AA ch II	legal
ch O t' e ts i	illegal
dz oo gh O s I	legal
ts' OO tL oo sh AA	illegal
ts aa x o ts ee	legal
z A g i j A	illegal
ts i w I z o	illegal
sh a tL aa ch' II	legal
ts' i dl ts AA	legal
sh aa dl o ts' E	illegal
dz ii b oo ts' e	legal
zh i gh oo zh a	legal
ch e d i z ii	illegal
j o n E ts' I	illegal
ts' ee dl i ts' oo	legal
z o t' I dz oo	illegal
ch' oo tL O z A	illegal
dz II h EE z o	illegal
ts ii gh ee ch E	illegal
dz e t E s e	legal
ch' ii w EE z oo	illegal
zh i L ch aa	legal
ch' a L a z I	illegal
j EE x EE sh E	legal
ts II tL' aa z a	illegal
ts E y OO j AA	illegal
dz AA X e s II	legal
ch' aa m aa ch' A	legal
sh ee L ch' ii	legal
ch II X I s A	illegal
ch' aa t AA ch' A	legal
z i L AA ts ee	illegal
z A L e z aa	illegal
z O m EE sh OO	illegal
ts I t ch' A	illegal
sh EE t AA j AA	legal
ts e b ee ts EE	legal
sh ee l oo ts' aa	illegal
ch' oo t' aa j i	legal
dz A tL z ee	illegal
ch' i tL' o j a	legal
s e tL' E zh O	illegal
dz e dl AA ch E	illegal
s oo l o sh O	illegal
s o X dz e	legal
zh e g O ch II	legal
zh OO l ts AA	illegal
s ee m ii z oo	illegal
ts a t AA s OO	legal
s o d oo sh a	illegal
ch' I t' II ts a	illegal
dz II k E zh O	illegal
z a tL' I ch' E	illegal
zh ii gh a zh ee	legal
ts o gh OO j EE	illegal
z AA h A dz aa	illegal
zh OO tL' oo dz EE	illegal
z O k' ts' a	illegal
dz aa w a z e	illegal
ch I w EE zh aa	legal
z E X II z o	illegal
s ee tL' oo z OO	illegal
zh E x e dz EE	illegal
sh A dl e j O	legal
ts' O X i z o	illegal
ch E k ch' A	legal
dz aa b sh ii	illegal
j AA m ts' AA	illegal
ts' a g I ts' a	legal
ch' A n O ch A	legal
ts II t' EE zh ee	illegal
ch' i tL' A ts o	illegal
z i m ii j I	illegal
z o dl z aa	illegal
j o g A z I	illegal
sh e d E sh OO	legal
ch' I X e ts' a	illegal
ch' O b A ts aa	illegal
z A t aa ch' ee	illegal
sh OO k j OO	legal
ch' EE m I ch' O	legal
z E X AA s O	illegal
s aa n O j AA	illegal
z a dl oo j i	illegal
zh O b ch' OO	legal
ts' O g ee s ee	legal
sh e d oo z E	illegal
ch II dl O zh AA	legal
ts' i dl A z o	illegal
zh I y AA ch' e	legal
j ii h I dz AA	illegal
zh EE d i dz e	illegal
z EE m ts' oo	illegal
z ii dl aa j aa	illegal
sh oo k' ts' o	illegal
z a dl i s e	illegal
sh O t OO z I	illegal
zh A x O zh i	legal
ch EE k AA s oo	illegal
dz aa tL aa ts II	legal
ch' aa y i j I	legal
s AA b aa z E	illegal
s O tL dz e	legal
s II gh o zh ii	illegal
ts' a b II ch' ee	illegal
ts e n i ts' O	legal
dz A n a ts' EE	legal
ts' aa b ee ts' I	legal
z aa tL' E dz EE	illegal
j I b E sh II	legal
sh EE x O ch' AA	legal
ts' E k ii zh i	illegal
dz e x OO zh aa	illegal
z I gh E ch' o	illegal
ts' e g i j a	illegal
j i t i ch' E	legal
zh E x I z ee	illegal
z ee t II dz A	illegal
z ii dl aa dz O	illegal
ch' II t' A j oo	legal
zh aa l e ts A	illegal
s ee h z aa	illegal
ts' a tL' OO j o	illegal
ch' a h OO dz oo	illegal
zh i m EE ts a	illegal
ch e l ee ts' e	illegal
sh oo x oo sh OO	legal
ch I n AA ts ii	illegal
zh oo t' ii sh e	legal
ts' i b ii s o	legal
z I b oo ts' I	illegal
ts' OO t e zh ii	illegal
ts' O x o ts' AA	legal
z o g oo dz e	illegal
z O k' ii ts a	illegal
dz EE tL' o ts e	legal
ts' o X AA ts' AA	legal
ch E k' I sh a	legal
ch' OO y a zh ee	legal
z e w aa sh O	illegal
z O d II s A	illegal
zh E tL' oo z ee	illegal
s o x o ch' O	illegal
sh a gh z ii	illegal
sh EE X OO ch' e	legal
j OO dl O s AA	illegal
ch A y a z e	illegal
ch EE n o ch a	legal
ts e x II z A	illegal
ch ii b EE ts' II	illegal
j O g i sh oo	legal
ts aa x OO ch' A	illegal
ts' EE t z e	illegal
j ii y ee z ii	illegal
zh e x I j ii	legal
ts a y ch' ee	illegal
zh oo y OO ch' oo	legal
z a dl A dz oo	illegal
ts ii k' E ch ii	illegal
ch' II tL' EE j EE	legal
ch' aa k' i dz E	illegal
z ii k' aa zh I	illegal
j ee n dz I	illegal
zh AA d AA s II	illegal
s A k ii ch' e	illegal
zh AA l oo s o	illegal
ts' I gh I j oo	illegal
z OO d aa z aa	illegal
ts' A t' O z i	illegal
sh ii k' aa j i	legal
j aa t' ii z A	illegal
j OO tL ee ch o	legal
j O l OO ts aa	illegal
ts II k' E ts oo	legal
dz II t E ts a	legal
sh E h i ch' o	legal
ts oo d ee z e	illegal
zh oo dl aa dz O	illegal
zh i w ee z O	illegal
z ee d o ts' EE	illegal
j II y AA zh AA	legal
z a tL' II z i	illegal
j a L oo ch' O	legal
z A w EE ts AA	illegal
dz aa tL' I j aa	illegal
zh a gh EE j i	legal
z A t AA dz O	illegal
ch' e dl ee dz II	illegal
ts' A X O zh O	illegal
sh ii w oo dz EE	illegal
ch A m II j A	legal
ch' aa t' E ch' A	legal
ch' II y AA j A	legal
ch' e X O ts' ii	illegal
s o k' ii ch' aa	illegal
sh a tL o ch i	legal
sh oo m ee s i	illegal
ts e gh dz O	legal
zh AA g AA z a	illegal
zh i h OO ch' aa	legal
ts' oo tL a ts E	legal
ts oo k' e zh AA	illegal
ts' oo L AA ts i	legal
ch E g A ch oo	legal
dz II w i zh E	illegal
zh AA t' i sh OO	legal
sh A b j I	legal
z E k z a	illegal
z o b EE zh a	illegal
ts' EE t O ch e	illegal
sh E x o j oo	legal
j ee X aa ch e	legal
ch' o tL' II ch' I	legal
s ee n I sh E	illegal
z A m A j E	illegal
ch I d a zh i	legal
ts AA m O zh oo	illegal
zh EE t zh OO	legal
ts oo h s ee	legal
dz II tL' EE z I	illegal
j o X O ch I	legal
s oo t' e dz e	legal
j oo w e z A	illegal
zh I b aa ts AA	illegal
s I n o dz oo	legal
z oo l I ts' ii	illegal
ts' a w a j I	illegal
j a L II z OO	illegal
j o tL ii z A	illegal
z O gh AA ch ee	illegal
dz AA tL OO z ee	illegal
sh ii k aa z ee	illegal
zh i k E ch' o	legal
zh O x ii ch a	legal
ts O dl E ts' I	legal
ts' i m ee dz i	legal
zh I t' ee ts' OO	illegal
j i dl oo j AA	legal
ch' II g a sh O	legal
sh OO b s EE	illegal
sh I g ee ts ee	illegal
z E l ii z oo	illegal
ts i l ch' OO	illegal
sh AA b aa zh EE	legal
z aa d e dz I	illegal
ts ee h E dz OO	legal
dz A gh AA ch' a	illegal
ts e tL e ts' OO	legal
ts' o dl AA dz ii	legal
z o d OO s oo	illegal
sh I n AA j EE	legal
ts' A m OO dz oo	legal
ts e gh I ts AA	legal
sh i m EE ts i	illegal
ts' i t' z O	illegal
ch o h ii ch A	legal
ch i y o j OO	legal
dz I d e ts' o	legal
z A h i z I	illegal
sh II b EE s E	illegal
z I w O s aa	illegal
j aa x sh ii	legal
sh a y E zh oo	legal
dz a tL' zh II	illegal
ch' I h ee z i	illegal
ts ii dl oo sh ii	illegal
ts O k' e z i	illegal
dz O m EE z A	illegal
ch' OO gh ee z II	illegal
s e w II ch o	illegal
ch aa L OO dz EE	illegal
ts' AA X I sh I	illegal
zh o X o dz O	illegal
z I n aa ts' aa	illegal
z I tL AA ch' OO	illegal
ch' aa b ii s e	illegal
ch ee b A ch' II	legal
zh EE b II zh ee	legal
ts o tL O ch I	illegal
z AA n O ch II	illegal
ch e n EE ts' ii	illegal
zh oo g o ts oo	illegal
s I X E z II	illegal
z II t aa sh E	illegal
z O b OO sh EE	illegal
sh a k AA z i	illegal
j O d OO ts O	illegal
ts' ee m OO ts' a	legal
z OO l A ch' ee	illegal
ch AA n e zh oo	legal
ch' A g E sh o	legal
s I x ii z aa	illegal
z a dl O ts' E	illegal
j EE tL' AA ts AA	illegal
sh OO tL' ee zh i	legal
s o gh i dz o	legal
dz oo L ts' oo	legal
z EE dl e j a	illegal
z II t II j ii	illegal
ts e L o s a	legal
ch II L e s II	illegal
dz o x aa z aa	illegal
zh ii d e z O	illegal
ts' AA k' e ts aa	legal
z OO d O z aa	illegal
zh o w a z I	illegal
sh OO gh aa ts OO	illegal
zh ee k' i z ii	illegal
z ee y ts' AA	illegal
zh oo k' i j A	legal
sh A tL' EE sh O	legal
z i t E ts e	illegal
j O w aa ch AA	legal
s II h oo dz EE	legal
s EE d AA sh ee	illegal
j aa t' ii j oo	legal
z aa y II ch O	illegal
ch' OO x e zh a	legal
ch O k O s aa	illegal
ch a l ee ch' EE	legal
s E w oo ch' ee	illegal
zh E k' z OO	illegal
ts' OO tL AA s e	legal
z A m II j OO	illegal
ts' AA k' OO z e	illegal
j ii d AA j e	legal
dz II d zh EE	illegal
ch' aa b aa sh ee	legal
z o t' oo s II	illegal
ts' A x ee z a	illegal
z o dl i sh A	illegal
z O tL' oo ts O	illegal
zh ee b II z EE	illegal
sh a tL aa ts' OO	illegal
ch' EE t I dz O	illegal
sh II L i ch' ee	legal
zh a k' o j EE	legal
ch' o t' ee ts i	illegal
ch' OO h OO ts aa	illegal
ts' ee t' II z A	illegal
ch AA t sh A	legal
ts e tL' o z a	illegal
ch o l II dz OO	illegal
ch' a m a ch' II	legal
ts' oo t' oo ts' O	legal
ts' E t i dz AA	legal
j aa tL OO dz oo	illegal
ch' EE t' II j aa	legal
ts O L o z oo	illegal
s e tL z II	illegal
ch' aa t' aa zh ii	legal
z ii h a dz II	illegal
s I L ee ts' o	legal
ch O l EE ts A	illegal
ch' II dl II z o	illegal
s oo y II ch' i	illegal
ch' i m i j II	legal
j o l ee ch I	legal
zh ii tL' o ts' A	illegal
ch' oo t' e ts E	illegal
sh I d O ch A	legal
s I dl EE z ii	illegal
ts aa tL EE ts' EE	legal
ts a n aa z E	illegal
ch aa k A z I	illegal
ts' OO L ee sh ee	illegal
dz II l sh a	illegal
z ii gh ee ts AA	illegal
z EE g zh e	illegal
ch' EE h EE s i	illegal
ch' II m E ch ee	legal
ts e n aa s oo	legal
s ee dl ii sh ii	illegal
j OO tL' o ch' a	legal
s O h II z II	illegal
ch e g a z oo	illegal
sh A l O s AA	illegal
ts I m oo z OO	illegal
s o n AA dz II	legal
j AA k AA j AA	legal
ch AA y II dz A	illegal
dz a tL' ts' e	legal
ch E m oo ch aa	legal
ch' OO h o ch oo	legal
ts o k aa zh II	illegal
sh A y II zh i	legal
ts o w e zh ee	illegal
ch' AA X a z o	illegal
z oo m ee j oo	illegal
ts' O k' AA zh II	illegal
ts' EE X EE ts' oo	legal
s ii m a s I	legal
z ii w sh aa	illegal
ch' E k O sh AA	legal
z ee g o ts O	illegal
ts A l aa sh a	illegal
z aa m a z a	illegal
ch ee n E z A	illegal
sh a L O ch ee	legal
dz e t EE zh E	illegal
dz e dl I sh I	illegal
j ee x ch' i	legal
ch aa dl aa s i	illegal
s a g aa j E	illegal
ts' E m i zh EE	illegal
ch OO l oo ts OO	illegal
z EE b EE zh I	illegal
zh e tL ch' e	legal
ts' ee b E ts' oo	legal
zh ee g aa ch OO	legal
zh ii x ee j i	legal
z aa n oo ch AA	illegal
j OO X E ts' a	illegal
j E t i ch II	legal
z O m i z II	illegal
dz e b II s II	legal
s OO k dz I	legal
zh o y aa j ee	legal
j I m e j OO	legal
dz oo X EE s ee	legal
z i m AA ts e	illegal
j i gh I z II	illegal
ch a x i sh i	legal
ch' E tL I zh a	legal
dz EE w E z E	illegal
s EE t e z ii	illegal
sh a t' ch E	legal
ts' ee h AA sh E	illegal
sh O h AA ch O	legal
ts' o w OO ch ee	illegal
ch oo tL O sh O	legal
z o d O z ii	illegal
j A X EE ch o	legal
ts a b OO ts II	legal
ts oo tL' AA j i	illegal
ch' oo tL' ii ts II	illegal
sh ee n O z o	illegal
ch A y II ts II	illegal
ts aa t ch e	illegal
ts OO t' A ch O	illegal
zh aa t AA sh OO	legal
ts' EE X E z aa	illegal
sh ii y A s a	illegal
ts ii b oo ts OO	legal
ts' E L I zh E	illegal
z A n ee z oo	illegal
ch A tL OO j ii	legal
dz aa h oo ch OO	illegal
ts a w I z E	illegal
dz e y e dz AA	legal
z OO w A z e	illegal
ts' E L II ch' o	illegal
ts i gh O ch' e	illegal
ch' o n I sh ee	legal
zh OO y aa ts' e	illegal
z o y e sh AA	illegal
ts' E b o ch EE	illegal
ch ee d zh e	legal
ts' EE t O sh O	illegal
zh O t E ch' aa	legal
ts A n o dz O	legal
dz E L II j E	illegal
dz oo t' a zh aa	illegal
sh AA X ee s ee	illegal
sh O n II zh i	legal
s aa k A sh II	illegal
z E t' ee sh i	illegal
ts' aa m II ch' O	illegal
s aa h e z II	illegal
z i n e zh ee	illegal
z o L OO zh O	illegal
s AA y e ch EE	illegal
ts O k' II j o	illegal
ch e tL' aa zh i	legal
z ee k oo ch' i	illegal
z i x EE z aa	illegal
ch' ii g ee z a	illegal
ts' O t a ch EE	illegal
ch' e h AA z AA	illegal
z II m aa dz A	illegal
ch' a y E s oo	illegal
s A L II sh oo	illegal
j AA h A ts' II	illegal
ts o g aa ch AA	illegal
ch I m EE s OO	illegal
zh ee l OO zh AA	legal
zh ee k' EE ch' e	legal
dz EE m i ch o	illegal
ch ii t OO ch' II	legal
sh ee x II ch' EE	legal
sh a gh o ts' II	illegal
ch e y oo ch' EE	legal
ts' ee h EE ch' oo	illegal
z i tL dz I	illegal
z oo gh o ch o	illegal
zh ee x a z I	illegal
ts II m ee zh i	illegal
s a l EE z AA	illegal
z o L a ch ii	illegal
s ee l ii j i	illegal
ch' o k' ii ts' E	illegal
zh II tL' a z II	illegal
ch O d ee s i	illegal
sh e k ii z ee	illegal
z ii h O s E	illegal
ch' a k' a ch' OO	legal
z A tL' AA ts' i	illegal
ch ee k' aa s OO	illegal
sh a w a z o	illegal
ts' ii y i z ee	illegal
z ii gh ee z a	illegal
ch e w EE sh A	legal
ts' O X a z EE	illegal
zh I tL' oo s AA	illegal
ch a b aa j A	legal
ch' O m A ch' EE	legal
ch' i k oo z oo	illegal
ch OO x AA ts AA	illegal
ts' II tL aa ts o	legal
ts oo t II z E	illegal
ch i L E ch' A	legal
ch' OO X e ch II	legal
s o x i j OO	illegal
ch' i tL aa z II	illegal
z ii m O ch' O	illegal
ts ee g o z o	illegal
z A d aa z e	illegal
ch II d a sh AA	legal
ch' OO t' ee j e	legal
dz I X aa zh e	illegal
z a g a ch' EE	illegal
ch o k ii dz o	illegal
ch I h E ch' a	legal
z a w oo z I	illegal
zh aa X OO ch E	legal
z O w oo ch o	illegal
ts' aa w I ts' E	legal
z AA h A zh AA	illegal
ch a h ii dz i	illegal
ts EE t O ch' AA	illegal
zh A tL oo ch i	legal
j A w A sh o	legal
ts' O tL' O ts AA	legal
ts' ii m A z i	illegal
zh OO y I ts EE	illegal
z aa gh ch' OO	illegal
ch e b II sh i	legal
zh OO L OO ch' i	legal
z O dl ts II	illegal
z i gh I s II	illegal
j i k' AA dz I	illegal
j A dl i ts I	illegal
ch A g ii z oo	illegal
j A h E sh AA	legal
ts aa y II sh aa	illegal
ts O tL EE sh o	illegal
s aa k' ii s II	legal
sh e n ii ch e	legal
ch' O X a j i	legal
ch E d j II	legal
ts II k' aa j AA	illegal
ch EE g ii dz II	illegal
zh I g oo ch e	legal
ts O k oo ch ii	illegal
ts A y A s AA	legal
zh EE m A ts E	illegal
s ee w ee s OO	legal
ch OO dl II zh E	legal
ch i b E ts AA	illegal
j e b a dz AA	illegal
ts' ii tL' oo ch' o	illegal
zh ii y OO zh aa	legal
s II k ii ch aa	illegal
ch i k' ee sh O	legal
ts aa t A j ee	illegal
j EE tL' II ts oo	illegal
z O tL' a ts' I	illegal
sh oo h EE ts' ii	illegal
s I n i s aa	legal
ts i k' s A	legal
z o l a ch ii	illegal
sh ee b ii ch' E	legal
sh o tL OO ts aa	illegal
ch I d A z ii	illegal
ts E l oo ts' e	legal
ch' AA tL EE z ii	illegal
s oo m s i	legal
sh AA t' o z o	illegal
z E t aa sh o	illegal
sh ee d II dz o	illegal
ch' AA dl ch' EE	legal
ch' o n a zh ii	legal
sh OO l I dz A	illegal
j aa x e ts oo	illegal
ch' O k O ch i	legal
z EE k i ts' ii	illegal
j OO L E j II	legal
ts e w O s I	legal
ch i y e j e	legal
zh AA m aa z ii	illegal
ts I l II z II	illegal
zh I tL' O ts' AA	illegal
ts' ee g I z O	illegal
dz I gh E ch' O	illegal
ts aa k' e j OO	illegal
ch e L aa sh E	legal
z a n o ts' II	illegal
j A tL' E ts' a	illegal
ts' EE k E ts aa	legal
sh O tL aa ch O	legal
j ee tL' AA s EE	illegal
s e dl I zh AA	illegal
ch aa x A s ee	illegal
z I b a dz ii	illegal
ts' O gh OO z ee	illegal
ts' E X o z II	illegal
dz OO l o ch OO	illegal
z E tL aa j a	illegal
s OO t' o z o	illegal
z OO tL oo ch' II	illegal
z II d aa s A	illegal
zh OO dl ii ts e	illegal
ch' AA tL' ee j oo	legal
ts' EE tL' OO ch O	illegal
ch EE gh AA zh EE	legal
z oo t' oo s oo	illegal
ch o d zh ii	legal
sh oo gh ee z II	illegal
ch I k' z e	illegal
z A m aa ts' I	illegal
dz aa b EE s A	legal
sh EE tL' ii ch II	legal
zh e tL AA zh O	legal
z ii l s ee	illegal
ts OO g e z ii	illegal
ts e tL A dz o	legal
sh O y aa ts aa	illegal
ts' ii w oo ch' OO	illegal
dz A dl E z II	illegal
z OO X II ch' O	illegal
z oo dl e dz aa	illegal
z E dl oo sh ee	illegal
ts o t' aa s aa	legal
j ee g s i	illegal
sh OO d oo dz II	illegal
dz i L OO z oo	illegal
ch OO X a z A	illegal
dz ii l O j oo	illegal
z AA k ch a	illegal
ts' EE n EE ch' e	illegal
ch EE w OO z I	illegal
ts EE h OO z aa	illegal
ts ee X o s i	legal
ts' EE d E s e	legal
s O n oo ts' o	legal
dz o x ii ts' E	legal
z A dl A sh AA	illegal
dz a t' AA s EE	legal
z AA k' ii j e	illegal
ch' AA g oo z O	illegal
z E l AA ts I	illegal
ch' oo d aa j e	legal
z a x aa sh AA	illegal
j o l II z a	illegal
sh o m oo zh oo	legal
ts EE gh j a	illegal
ts II g II ch' oo	illegal
ts' A b oo sh ee	illegal
ch ii d ch' O	legal
j ee b i ch AA	legal
ts oo dl aa sh O	illegal
z I t I ch' oo	illegal
ts O t' ee z ii	illegal
s A gh ii j aa	illegal
zh i t' ch o	legal
z aa h aa ts AA	illegal
sh EE gh II ch e	legal
ch' aa t I s oo	illegal
sh E m e ch' EE	legal
zh EE h aa zh i	legal
zh ee L ee zh I	legal
zh o gh EE ch A	legal
z I g E ts' a	illegal
ts ii y AA sh E	illegal
dz O t ee ts oo	legal
ts AA m aa ts' i	legal
zh AA n a sh e	legal
zh o l O ts a	illegal
sh e t' i j i	legal
s oo d ch o	illegal
z a l EE z ee	illegal
ch ii t' E ch II	legal
ch OO b ii dz ee	illegal
z I L aa z aa	illegal
sh II n ee s oo	illegal
ts o tL' A z ee	illegal
ts oo t' OO ts A	legal
ts' oo dl E j AA	illegal
j I k A ch' II	legal
ch E tL A ts EE	illegal
dz AA t o j a	illegal
ch' o y s EE	illegal
ts' e g II z O	illegal
z e tL' II z EE	illegal
s aa t' II ch aa	illegal
zh II m s AA	illegal
s EE n i ch aa	illegal
ts' a k' dz ee	legal
s AA t' II ts e	legal
zh e b II sh oo	legal
sh EE h i ts' I	illegal
ts II t' E zh E	illegal
s I t z AA	illegal
s A X z o	illegal
z O L o s a	illegal
s O tL z i	illegal
ts A h a sh I	illegal
dz ii m z OO	illegal
ch' AA m aa ts' ii	illegal
zh II dl AA sh O	legal
s a y EE dz EE	legal
s ee d ts aa	legal
ch' AA t II s A	illegal
ch' a h oo ts' A	illegal
ts' ii h II zh ii	illegal
ts' i m AA s ee	legal
ch' i gh ee ch ii	legal
ts' ee n OO zh e	illegal
s E d j O	illegal
dz ii w o dz I	legal
j EE k i sh o	legal
z aa k E z i	illegal
z I n aa z i	illegal
dz A X EE z ee	illegal
dz II tL' I z O	illegal
s A m o z AA	illegal
zh E n E j a	legal
dz aa g s i	legal
dz OO x O j E	illegal
dz EE t ts' a	legal
z oo tL' o sh AA	illegal
j aa tL' ee zh e	legal
s AA y AA ch E	illegal
s E gh AA zh OO	illegal
z aa tL II dz E	illegal
ch' e y O z a	illegal
z I w EE z aa	illegal
sh E w OO z I	illegal
dz E y ii z A	illegal
j O l aa sh AA	legal
j i d I sh EE	legal
ch' e x oo zh AA	legal
s i b O j II	illegal
j e d oo dz II	illegal
j o k EE zh EE	legal
sh EE gh aa z oo	illegal
ch A y dz ee	illegal
ch ee X AA z o	illegal
sh o h OO ts' ii	illegal
ch' e X O zh O	legal
ts o k O zh ii	illegal
z e dl e s A	illegal
zh OO t' ee ch oo	legal
z A m OO dz e	illegal
z i X OO ts O	illegal
sh oo tL e zh OO	legal
ts' aa d o ch e	illegal
z E gh ch O	illegal
ch' O t' ch' O	legal
z AA k o z OO	illegal
z o k' sh ii	illegal
j o b EE j E	legal
ts' I x aa sh OO	illegal
sh aa l II ts' I	illegal
dz ii gh ii ts' a	legal
z EE dl a j EE	illegal
s o tL' AA ch ii	illegal
ch' AA tL' I j AA	legal
ch' a dl aa z EE	illegal
z o y A ch' O	illegal
ts OO b OO ts' II	legal
ch OO dl aa z aa	illegal
sh A b aa zh o	legal
z ii L I z I	illegal
ts E gh ii ts I	legal
ts ee x a zh E	illegal
z AA d ts' o	illegal
zh a d oo ch A	legal
z OO tL' I z O	illegal
z aa tL AA dz ii	illegal
z ee n ee j i	illegal
z OO k' A ts i	illegal
ch ee h o j OO	legal
ch' e g o j II	legal
s ii m oo ts A	legal
ts' a tL j i	illegal
s ee t A z E	illegal
ch' O k' OO ts' O	illegal
j E t' OO ch o	legal
ch I t' i zh EE	legal
zh a w I j ii	legal
ch' E b E ts I	illegal
ch O k' aa z a	illegal
z A y A ts' ii	illegal
j O d EE s a	illegal
z i k i z ee	illegal
dz e t' O j o	illegal
ts ii w ii j AA	illegal
ts A m a zh O	illegal
zh E tL' EE dz aa	illegal
sh a t a ts E	illegal
z II L OO z OO	illegal
j A tL' AA ts a	illegal
z a l aa sh o	illegal
z A b I ch ii	illegal
zh a y E ch O	legal
ch' EE tL aa ch' a	legal
z o tL a ch' ii	illegal
s O k' II z AA	illegal
ch a k' ii z o	illegal
z oo L II z ii	illegal
zh EE gh ii s ii	illegal
s II y oo z OO	illegal
z O t AA z ee	illegal
ch' i tL aa ts AA	illegal
dz A t' o s oo	legal
j II t' i ch' I	legal
dz A m I s I	legal
sh O n II ch' II	legal
z ii dl AA z I	illegal
j A dl II ch ii	legal
sh OO l OO j OO	legal
z A k' I z II	illegal
z e g z a	illegal
sh E h z E	illegal
dz AA L aa s oo	legal
j ee w O s aa	illegal
sh E gh OO z aa	illegal
ch' ee y AA sh o	legal
ts a d e ch II	illegal
ts AA L O j A	illegal
j AA h i ch e	legal
ts' I k' I ts I	legal
ch' EE t aa ch' AA	legal
dz I l ee s e	legal
z ee gh a s O	illegal
ts aa m E z ee	illegal
z ee gh a ts' i	illegal
dz AA d E zh aa	illegal
zh a g i zh E	legal
ch' EE dl ch oo	legal
ch' O w OO j O	legal
z a l i j E	illegal
z aa m E j i	illegal
ts' o d II ch' oo	illegal
zh e d oo ts' e	illegal
z O X ii sh EE	illegal
ch' aa tL EE ch OO	legal
z ii m a sh aa	illegal
s A g AA ts' aa	legal
ch ii h I ch' a	legal
ts II gh oo z e	illegal
ts AA X OO s oo	legal
ts' a k' II ch' e	illegal
zh aa k AA s a	illegal
dz aa tL A z A	illegal
j ee gh o dz II	illegal
ts A L o ch' i	illegal
zh O gh ii sh e	legal
ch a k' ii ch AA	legal
z ee w O z O	illegal
dz i b oo zh ee	illegal
s a x EE dz EE	legal
sh oo L i ts ee	illegal
z aa w ee sh O	illegal
ts' e tL' AA z a	illegal
zh OO k e ts' a	illegal
ch E tL sh ii	legal
s a l I ts O	legal
ts' e w I ts A	legal
j aa l O s ee	illegal
z A t' ii sh oo	illegal
ts' ii gh e ts E	legal
dz E k' E z ii	illegal
ch' ii k dz aa	illegal
sh o L AA dz I	illegal
ch i x O s EE	illegal
z oo k A j EE	illegal
ts' II tL AA dz oo	legal
z ee k e zh E	illegal
z I m A ch o	illegal
zh e g i s A	illegal
ch O tL' A dz oo	illegal
s ee k oo z A	illegal
sh O gh E sh o	legal
s AA X AA ts' E	legal
ts AA l z o	illegal
ch' i k' OO z oo	illegal
ch oo x ii zh O	legal
ts II L I j EE	illegal
z oo m e ch' ii	illegal
ch' ee l OO z O	illegal
z A h AA dz O	illegal
dz OO X AA sh oo	illegal
ch' EE w i ts' II	illegal
s aa k O zh a	illegal
zh oo l aa dz A	illegal
dz E tL' ii j ee	illegal
z e x zh e	illegal
ts i w EE zh OO	illegal
ts' OO g ii z a	illegal
zh II l O ts' e	illegal
z e k z O	illegal
ch' i m e ts' EE	illegal
dz ee y ts i	legal
ch' AA tL aa ts O	illegal
ch A k' aa dz o	illegal
ts II k' aa ts I	legal
z A L zh ii	illegal
sh II h ii ch II	legal
s O t' EE sh E	illegal
ts' OO X EE z O	illegal
ch AA x e zh a	legal
ch' a m zh OO	legal
sh o k' oo s o	illegal
zh O t ii z aa	illegal
ts E t' EE dz ee	legal
dz EE gh II zh OO	illegal
ts' o y OO z o	illegal
ts' i m aa ch EE	illegal
j o t j E	legal
ts' ee t II j O	illegal
j I m OO dz OO	illegal
j e g i ts' o	illegal
z O h A sh I	illegal
s EE tL' aa j E	illegal
sh AA gh o ch' ee	legal
z A w o z I	illegal
ch' a w A s ee	illegal
s OO y ts OO	legal
ch o n E ts OO	illegal
ts E x A s i	legal
ch' AA k' EE z II	illegal
zh E h o sh I	legal
z AA m EE s i	illegal
zh o y dz OO	illegal
ch' E gh II ts' e	illegal
ch a h a ts' AA	illegal
s EE d o sh o	illegal
ch' O t ts' a	illegal
z e tL' AA ch O	illegal
ch E y e j I	legal
z ii g EE sh a	illegal
z I dl ts' A	illegal
ch' ee l I ch' A	legal
ch' AA d ch' OO	legal
s OO dl OO j OO	illegal
zh II w OO j II	legal
s a y i ts II	legal
z II k e ts EE	illegal
z O y II z AA	illegal
z O dl AA s A	illegal
ts EE t ee ch ii	illegal
ts ee n O ch' ee	illegal
j EE b ii sh AA	legal
ch' O X z OO	illegal
ch' OO m EE dz a	illegal
ts ii tL' AA j oo	illegal
s oo t' ee z EE	illegal
sh AA tL' I ch aa	legal
s ee x a j oo	illegal
ch' E dl I z A	illegal
z I l EE ts II	illegal
dz EE x e ch A	illegal
z EE l E ts ii	illegal
j E tL I j ee	legal
ch ii t' OO j A	legal
z O tL II zh II	illegal
z OO n ch aa	illegal
zh i g I s i	illegal
zh EE tL' oo ts' i	illegal
z oo tL' II ts' AA	illegal
ts' ii y E dz aa	legal
dz O gh I s A	legal
dz aa y I ch OO	illegal
ch i n z EE	illegal
ts' ee t' z i	illegal
ts' ee b ii ts AA	legal
ts' o w I j II	illegal
z AA l ts' I	illegal
ts ee b OO ch' ee	illegal
ts o gh I dz I	legal
zh e d AA z A	illegal
z II y OO dz ee	illegal
dz e tL' z O	illegal
z E h EE ch AA	illegal
ts EE b dz aa	legal
z I gh EE ch' A	illegal
z AA y II dz OO	illegal
ch' A X A ch' o	legal
ch I gh I s E	illegal
s ee tL' II z i	illegal
zh II l A z E	illegal
z e t i ch' ee	illegal
ch I k a z ee	illegal
ts AA g E ch' AA	illegal
ts' OO tL' e ch A	illegal
zh A g II ts' AA	illegal
s a k dz I	legal
j e x OO ts' OO	illegal
sh i l ee s aa	illegal
ch O L o z oo	illegal
dz OO l a j i	illegal
ch' AA t' ii sh AA	legal
ts e g ii z II	illegal
ts' A dl OO ch aa	illegal
zh E k' A ch O	legal
j i y aa ts E	illegal
sh O d e ts O	illegal
ts' ee d dz oo	legal
ts' aa x ii j ii	illegal
ts O X o ts A	legal
zh II x O ch' i	legal
ch' ee g O s i	illegal
ts' EE dl aa ts o	legal
ts' ii g a sh e	illegal
ts' oo b oo dz AA	legal
dz EE dl aa dz o	legal
sh O tL o zh EE	legal
s AA t' II ts' O	legal
ts' I x ee z E	illegal
dz II k' II sh A	illegal
ch' aa w OO ch' ee	legal
j oo k EE zh AA	legal
zh o h oo ch' a	legal
z E g aa ch A	illegal
ts' ii gh ii z e	illegal
dz EE x O ts' OO	legal
ts' A m ts' ii	legal
sh e g II ch' E	legal
zh oo d I ch oo	legal
z I t' I z O	illegal
ts a l i sh A	illegal
j O X ch OO	legal
sh aa y OO sh O	legal
ts' I x o sh AA	illegal
j OO gh e ts O	illegal
zh O gh O ts' a	illegal
z AA n EE ts i	illegal
j A L O ch' i	legal
z e w II zh II	illegal
dz e y o z AA	illegal
zh i n AA z AA	illegal
dz E X A ts OO	legal
z a L i s E	illegal
zh I tL oo sh A	legal
j aa X II s o	illegal
ts' i y OO dz aa	legal
ts aa dl sh e	illegal
z oo tL' OO z O	illegal
ts' aa X aa z I	illegal
s aa dl EE dz II	legal
zh o t e ch ee	legal
z a L ts' ee	illegal
zh E k' OO z e	illegal
ts' ii w oo zh OO	illegal
dz A g I ch' A	illegal
sh O b OO j a	legal
z E y e z O	illegal
z A X I ts' a	illegal
j AA k OO z o	illegal
j EE k' ee s a	illegal
ch' a x zh I	legal
j E t' I j O	legal
dz OO n a z ee	illegal
z A X I sh A	illegal
ts e h o zh A	illegal
s I x o s AA	legal
ch' ii b OO zh I	legal
zh e t EE z O	illegal
s ee gh e ts aa	legal
sh I tL' i ts' II	illegal
ts ii g ts' OO	legal
dz aa L OO j EE	illegal
ts' E X o s a	legal
ts' OO g sh o	illegal
z ii dl EE j OO	illegal
s ii dl O j o	illegal
s i b A j ee	illegal
z OO l ii z i	illegal
ts' ee tL o s e	legal
ch aa k ch' II	legal
ts EE w i z EE	illegal
s OO g aa zh OO	illegal
ch' o d sh o	legal
zh I k ii dz OO	illegal
dz E t' dz E	legal
j II n j E	legal
ts' EE g E ts AA	legal
zh O t' e sh AA	legal
z e tL i ts' i	illegal
j II h II ts a	illegal
z ee h a s E	illegal
z o y E zh OO	illegal
dz aa y aa z OO	illegal
z EE tL EE j ee	illegal
z II k' i ts' ii	illegal
s AA dl ee ch OO	illegal
ts ee tL i ch' A	illegal
zh ee m o ts' o	illegal
ts' ee d ee zh a	illegal
ts' O k' a z OO	illegal
sh II X oo ts' o	illegal
ts' oo tL i ts' o	legal
sh E k' oo z A	illegal
ts' i w I s aa	legal
s OO k' ch AA	illegal
z ee k' e z o	illegal
s e y AA z e	illegal
z e x E sh A	illegal
ch o L a ts I	illegal
dz A k' z oo	illegal
dz a b ii ch' ii	illegal
ts' O t' AA ts E	legal
z e k' ee ts ee	illegal
s ee n A dz i	legal
s a t ee j oo	illegal
sh ii t' a j ii	legal
ts AA k II ts I	legal
zh ee g zh oo	legal
ch' o gh I z a	illegal
z A X A j A	illegal
s E l i ts o	legal
ts EE y ts' AA	legal
ch ii x E ts II	illegal
ch' a t' ch' A	legal
sh o tL i z O	illegal
s II gh aa ch' AA	illegal
ch' OO y AA z ii	illegal
ch e k' II dz i	illegal
ch' e w sh OO	legal
ch i x o j OO	legal
zh I d I sh ii	legal
ts I t' ee sh EE	illegal
sh a x a ch' e	legal
ts o X e dz aa	legal
ch OO y ii zh ii	legal
ch' ii X o ts I	illegal
ts ee tL a j E	illegal
zh II t aa z e	illegal
ch' EE l E z A	illegal
sh e k' O j a	legal
ts' oo k a s ii	legal
ch I gh ts O	illegal
j i h e ch e	legal
s AA L O zh e	illegal
dz OO gh II ch' E	illegal
z a b ii j A	illegal
sh E tL I ch' ii	legal
ch e b A ts E	illegal
ch' o gh ii ts O	illegal
j E tL' AA j O	legal
dz AA tL AA ch' E	illegal
ts ee l A ch' a	illegal
ch A k e dz A	illegal
z O m OO zh aa	illegal
sh a k a ch ee	legal
sh OO y o ts' OO	illegal
z i dl i sh E	illegal
zh E n ii dz e	illegal
dz ee w I ts' II	legal
s EE t' a z aa	illegal
dz O tL' j o	illegal
z AA t' aa ch i	illegal
z E l aa ts a	illegal
z i m E ts I	illegal
ts' EE L E zh EE	illegal
j a X e z A	illegal
ts' A t O ts' EE	legal
sh a gh ts O	illegal
dz I tL II j E	illegal
ts' i m ts' ii	legal
z o b o z O	illegal
s ii x ii zh OO	illegal
ts' a n EE ts ee	legal
zh e g EE ch II	legal
ch' oo h I z O	illegal
ts OO tL i ch aa	illegal
ch' AA k' O z II	illegal
ch i X a ch I	legal
z E g I s oo	illegal
ts oo tL a ts' oo	legal
ch' a X aa z A	illegal
zh OO dl j OO	legal
s AA l II z o	illegal
ts e b AA ts AA	legal
sh ii tL e s ii	illegal
z I d e sh EE	illegal
s EE tL' II j ii	illegal
zh e b A j a	legal
ts' ee m ee z AA	illegal
z oo y E ch AA	illegal
zh aa t o s EE	illegal
sh ee dl j ee	legal
dz I t zh o	illegal
sh E t' ii zh ee	legal
dz II g AA z OO	illegal
zh II h aa zh AA	legal
ts OO k i sh I	illegal
zh OO k' E z e	illegal
j a w o s ee	illegal
z ii b ts' II	illegal
s II d o ch A	illegal
sh ii g ii s EE	illegal
sh EE dl OO ch o	legal
ts' ii m i ch' I	illegal
ts' e k ii z a	illegal
z i gh o dz oo	illegal
s I b aa ch' o	illegal
z E x ii ts' e	illegal
z O l o sh II	illegal
ch oo L O ts' ee	illegal
ch I m a z AA	illegal
ch' a l zh E	legal
sh aa dl oo ts EE	illegal
ts o g ii ch ee	illegal
j EE X ii j ii	legal
z A x EE s ii	illegal
zh aa m aa ch' OO	legal
j e dl O zh II	legal
ch ii d A z oo	illegal
ts' oo d E z o	illegal
j EE X AA j e	legal
ts e dl EE s oo	legal
j O t I j oo	legal
ts a X o z aa	illegal
z I t' oo z i	illegal
z AA t' ee s e	illegal
z OO k' o ch' ee	illegal
ch' AA gh z EE	illegal
ts I k I ch E	illegal
ch ii l EE zh oo	legal
s A g II ch aa	illegal
ch' A w o ch' I	legal
zh OO b zh II	legal
dz O x A dz I	legal
dz AA X A z ii	illegal
ch ii g o zh ee	legal
z AA k' z oo	illegal
dz O n OO z aa	illegal
zh A k ch' E	legal
ch' EE k' OO ts' aa	illegal
s OO X ii ts' a	legal
j EE n EE j e	legal
ch' II dl oo dz e	illegal
ch OO b OO ch' II	legal
s ii b OO zh O	illegal
zh a tL' aa s aa	illegal
ts II b o sh i	illegal
zh i x o ch e	legal
s E m OO z A	illegal
s aa k' E dz E	legal
j ii w aa ts O	illegal
z EE h i ch' O	illegal
z aa x ee zh ii	illegal
s i d EE ch o	illegal
ch' II k' EE zh EE	legal
z II tL' I z o	illegal
sh a L E ts' e	illegal
j A h e ch' EE	legal
ts' ee l I dz A	legal
ts' AA k A ch' AA	illegal
z oo tL O ts' EE	illegal
zh OO b e zh o	legal
zh a tL A sh a	legal
ts O g AA sh ii	illegal
z i k' E dz a	illegal
j ii t' o ch AA	legal
j ee x OO ts OO	illegal
z AA gh O s i	illegal
sh OO X ch' OO	legal
z O w A dz ii	illegal
z EE d i ch aa	illegal
sh A k' oo sh a	legal
z e y II z I	illegal
sh EE L ii ts' e	illegal
zh O tL' aa ch' ee	legal
ch' E h ee ch II	legal
ch' AA k AA sh AA	legal
ch' oo w ii s OO	illegal
sh I tL A z A	illegal
ts a g EE ts o	legal
z AA m II dz o	illegal
z o x A dz a	illegal
dz a g ee z O	illegal
z o n I ts ee	illegal
j O w a ts AA	illegal
z O l i ch aa	illegal
ts' II x oo sh a	illegal
j oo t' i s ii	illegal
dz e tL o z AA	illegal
sh II tL' ch e	legal
ts' OO d i sh I	illegal
ch' AA L dz ii	illegal
ts' ee w II s O	legal
j aa x A z II	illegal
ch' a tL a dz II	illegal
dz OO t' ii ch ee	illegal
s ii x a z OO	illegal
ch' ee t' E z O	illegal
zh I b oo ts i	illegal
j e l II sh oo	legal
z EE h I ts' AA	illegal
sh a h E sh i	legal
z oo x ts ee	illegal
s ii L e s A	legal
sh ii x zh EE	legal
z AA m OO ch' E	illegal
sh a m a z II	illegal
ch EE w E z I	illegal
s i k EE ts' II	legal
ch' a k' aa ch o	legal
ch' O h o s e	illegal
sh i t e zh II	legal
zh ee L O j II	legal
zh II k' O z EE	illegal
ts ee m aa ch' oo	illegal
ts' i y AA zh EE	illegal
ts' E k O sh O	illegal
z O b ii ch I	illegal
j oo x aa ts' i	illegal
ch E t I ts aa	illegal
j ii x A j A	legal
sh I x ch' o	legal
ch' e L II ts ii	illegal
dz aa n OO z I	illegal
j ii g oo ts EE	illegal
j O tL' oo s EE	illegal
ch oo X AA ch e	legal
ts i t' O z ee	illegal
ts' oo m OO ch A	illegal
ch' II dl oo zh e	legal
ch' i y i zh ii	legal
z aa t o ts aa	illegal
z O t oo ch AA	illegal
ts' I k e zh e	illegal
ch' o t' I zh o	legal
sh O g e ch' II	legal
j OO w a s I	illegal
zh O k' aa sh o	legal
ts' EE l z I	illegal
sh I L j II	legal
ts' ee tL' ts A	legal
ch' OO y ch i	legal
dz ii tL ch AA	illegal
ts OO b E z o	illegal
ts' i dl s oo	legal
z EE k aa z AA	illegal
ts' I d o ts' o	legal
ts OO gh o ts' OO	legal
j AA X A dz oo	illegal
z AA k ii j oo	illegal
j E m ii z A	illegal
sh I d o ts oo	illegal
ch i n E sh aa	legal
sh E g I z e	illegal
ch' OO x ii ts' aa	illegal
ch' a g E j ii	legal
dz I X EE sh a	illegal
ch oo m ii sh AA	legal
z e tL A ch EE	illegal
ch' I dl A ch' A	legal
ch aa k' i sh o	legal
s O g ii ch' e	illegal
j o w AA s e	illegal
j ee t EE z EE	illegal
ts oo n zh o	illegal
z ee h OO j ii	illegal
z ii y o ts' ee	illegal
j a l EE s O	illegal
z oo X aa sh II	illegal
ts' O d EE ts' EE	legal
ts i x z OO	illegal
ch ee X I j O	legal
ch' i tL' i sh aa	legal
ch' aa dl oo dz ee	illegal
sh ii k o sh A	legal
ts' OO h ii ch o	illegal
ts oo tL z OO	illegal
s I x ii sh I	illegal
s ii w O ts' O	legal
z oo h ii ch' ii	illegal
z a b i zh e	illegal
ts O k' II sh O	illegal
ts' EE m e s A	legal
ch' AA t' a dz ii	illegal
z AA g II s oo	illegal
dz II X II j E	illegal
ch' a b OO j ee	legal
dz A t II ts' i	legal
sh o dl EE sh a	legal
dz e d OO ch O	illegal
z A k' AA zh a	illegal
ts ii w i s e	legal
z i gh e j II	illegal
ts ii k' oo ts' O	legal
dz AA d II ts oo	legal
ch' e d AA j ee	legal
z a tL ii sh EE	illegal
dz i l oo dz EE	legal
ch II gh o z I	illegal
z o k i ch o	illegal
z o h EE zh II	illegal
ts' oo m aa sh I	illegal
j e k OO s E	illegal
j ii tL' ts' aa	illegal
z I L o ch' EE	illegal
z o n ee ch E	illegal
ch' ee n i ts' AA	illegal
sh AA x oo ts i	illegal
ch' a x sh ii	legal
j i X aa dz i	illegal
s oo m O dz AA	legal
zh oo t' A zh I	legal
sh a tL a ch o	legal
ts' E x z a	illegal
sh EE l aa s o	illegal
zh aa m ii z E	illegal
dz aa dl j E	illegal
ts oo g ii z o	illegal
z A g OO z E	illegal
s ii b OO dz ee	legal
ts' EE y ch o	illegal
s aa d e zh o	illegal
zh e m ch' EE	legal
ch' o X AA sh ee	legal
ts A g ee j o	illegal
ch I x i j I	legal
j EE b ii zh EE	legal
dz A d OO j a	illegal
ch' EE y AA ch' AA	legal
j I g oo ts' ii	illegal
z e x I z a	illegal
z o b s i	illegal
sh i h E sh OO	legal
dz aa L AA ts AA	legal
j a t EE ch' II	legal
ch o w EE ts A	illegal
j ii g II ch a	legal
ch i X EE ts' E	illegal
ts' oo t sh O	illegal
z i L I j I	illegal
ts' a n dz A	legal
ch a t' I s a	illegal
z AA m O s i	illegal
s I y o s aa	legal
zh oo n OO z a	illegal
zh I h aa z O	illegal
ch aa w aa ch EE	legal
ch I gh I ts' oo	illegal
ch' o gh A ts' aa	illegal
ch II tL aa dz A	illegal
s ii h i ts' oo	legal
ts' EE tL' II dz e	legal
s I k a dz ee	legal
ch aa dl z EE	illegal
ts' AA tL i z oo	illegal
j O k E s I	illegal
ts ee X e ts' o	legal
ch' II t a ts o	illegal
z EE m II sh a	illegal
ts' i x e sh ee	illegal
j aa m O ts e	illegal
ch aa k e ts' ee	illegal
ch' ee l I z AA	illegal
z II b II ch oo	illegal
ts OO g EE z o	illegal
ts' ee dl e sh A	illegal
z ii k II s O	illegal
sh OO n AA sh o	legal
dz ii t ii zh E	illegal
dz oo l aa zh O	illegal
j EE h I ts' O	illegal
ch e X E ts' II	illegal
z A dl I ch II	illegal
dz I b E z o	illegal
ch' e k EE sh ii	legal
ch' oo y e zh E	legal
ts ii l EE ch ii	illegal
ts' e b EE ch i	illegal
zh OO g o ts O	illegal
ch ee dl A zh aa	legal
j a d a z EE	illegal
z A tL' o z oo	illegal
ts a k' a ch e	illegal
dz A gh oo ch' o	illegal
sh ii b e j aa	legal
ch' II gh aa sh I	legal
z EE l AA sh ee	illegal
s o h I ch i	illegal
ts' i l o j AA	illegal
dz EE m O z EE	illegal
s o g II ch i	illegal
zh e t' dz EE	illegal
zh EE w A z O	illegal
ts e k' i ts oo	legal
ch' II d I ts' A	illegal
zh O x e zh aa	legal
ts A t' oo j EE	illegal
z OO t' ee ch A	illegal
ts' EE x AA z oo	illegal
ch' AA k aa ts oo	illegal
ch' A k i zh EE	legal
ts' o b A sh A	illegal
s II l O dz E	legal
zh A tL AA z I	illegal
j A d ii ts' ii	illegal
ts' ee dl a j o	illegal
j ee tL' o ts A	illegal
zh a l a ch o	legal
z AA tL' EE z ee	illegal
ch I d A s o	illegal
s E t' ts A	legal
s aa d I ch' I	illegal
ch I b o j e	legal
ts ee tL' ii dz I	legal
s ii t' ee z II	illegal
ch' a t' ee s II	illegal
z I t' OO dz OO	illegal
z ee m zh O	illegal
sh AA n i ts E	illegal
z A k' e zh o	illegal
ts' ii gh AA dz o	legal
sh aa b ch' ii	legal
ch' EE X AA s AA	illegal
dz oo g z I	illegal
j i b OO ts ee	illegal
ch' i w EE ch' AA	legal
z i gh EE ts' aa	illegal
z aa g EE ch' II	illegal
s E w oo zh I	illegal
ts o y a j aa	illegal
s ii x oo j oo	illegal
ts OO y e ts' I	legal
j ii k a s EE	illegal
sh E L OO j a	legal
ch' aa k' AA z a	illegal
j AA l II z oo	illegal
ch' I L O j AA	legal
ts AA g A j e	illegal
ch EE X z II	illegal
ts E dl e s e	legal
z I tL a zh A	illegal
ch OO l a s AA	illegal
sh i X o ch E	legal
z AA t' z a	illegal
dz o x e sh AA	illegal
ch' I d ii dz i	illegal
z EE t' z AA	illegal
z OO l OO z AA	illegal
ts AA b O dz a	legal
s AA L AA ch' oo	illegal
z e x dz AA	illegal
zh i x i zh ii	legal
ch i g e zh ii	legal
ch i t' E zh E	legal
dz OO tL a ch E	illegal
sh OO tL' OO s oo	illegal
sh II gh A s e	illegal
ch E n AA ch' II	legal
dz OO n EE s oo	legal
ch' a h OO sh aa	legal
s i t e sh ee	illegal
z EE k' ii s i	illegal
sh EE dl A sh ii	legal
ts' OO k' ii s ee	legal
dz OO t' oo ch' EE	illegal
j ee w oo s aa	illegal
zh aa h a z ee	illegal
ch' A t e ch' aa	legal
z ee tL ee z E	illegal
dz O tL' ch' oo	illegal
dz OO tL' II ch aa	illegal
ts' ii m II ch' OO	illegal
ch' ii X aa j ee	legal
z ee w OO ts e	illegal
dz oo w o dz o	legal
z OO X aa zh ee	illegal
ts' O x OO ts' aa	legal
sh EE tL II ch EE	legal
sh A w OO z ii	illegal
ch' O k' A sh a	legal
z OO h ee sh E	illegal
dz AA gh E z o	illegal
j I b aa ts oo	illegal
z EE b O ch' OO	illegal
sh oo k' e j E	legal
s I t' O ch A	illegal
ch' o t' EE z ee	illegal
ts EE L AA z A	illegal
ch OO b O zh I	legal
z I k' E zh ii	illegal
ch' e tL' II j o	legal
z i x II ts aa	illegal
z AA g O ch' I	illegal
z E t E dz e	illegal
j i n AA ts AA	illegal
s E h dz ii	legal
z EE t' E s oo	illegal
ts ii h ii z ii	illegal
ts OO w s OO	legal
s I h EE ts ii	legal
dz aa dl II zh II	illegal
dz A x aa dz aa	legal
z E k EE ts' E	illegal
ts a t' I ts o	legal
ch E h EE ts' a	illegal
ch' A L ii dz OO	illegal
ch I m e ch a	legal
ts a k aa z E	illegal
z I dl AA ts OO	illegal
j E x AA zh E	legal
j o tL' EE dz AA	illegal
z oo h II ch' i	illegal
ts' II g i ch ii	illegal
ch' E dl a ts oo	illegal
z A w ts EE	illegal
ts ii L AA ch ee	illegal
ch' ee t' O ch' e	legal
ch' aa L i dz I	illegal
s AA x A ts aa	legal
ts' o m AA ts' I	legal
ts' ee tL E j a	illegal
ch' aa dl oo j i	legal
s o m i ts o	legal
ts A gh AA z ee	illegal
sh I t o dz ee	illegal
ch' I l aa z II	illegal
s ee d O dz oo	legal
ts EE x sh EE	illegal
z OO t' e z oo	illegal
z EE n E sh ii	illegal
ch E l aa z O	illegal
ch' E b o j AA	legal
zh ee L j o	legal
j aa dl OO ts' EE	illegal
zh i tL' oo ch' e	legal
z II l A j II	illegal
s a n oo zh e	illegal
j II dl A z EE	illegal
ch' A L i j e	legal
ts OO t' oo ts' ii	legal
ts' EE d E ts aa	legal
z aa L z e	illegal
ts' OO k a ch' aa	illegal
ts' i h EE dz ii	legal
j A g aa j ii	legal
ch' a L E sh oo	legal
sh AA L aa z a	illegal
ts I tL II s a	legal
zh e y ii z E	illegal
sh A b ee z A	illegal
ts' e k' a dz O	legal
ch e k' O s aa	illegal
ts' O l z I	illegal
ts OO n AA ch E	illegal
s I w E ch E	illegal
ch' e b AA ch e	legal
zh A y ee z I	illegal
ch' a l I ch' i	legal
sh OO x O sh o	legal
zh AA t' E ch II	legal
j o w o ch e	legal
zh II t O ts' II	illegal
ch ee g ch o	legal
dz ee w e sh O	illegal
ts a k EE ts i	legal
ts e w OO j AA	illegal
z E L I zh i	illegal
ch' oo k' oo j a	legal
j oo tL' EE ts' OO	illegal
s a t O s O	legal
ch' A X I j a	legal
sh oo k O zh a	legal
zh o X i s aa	illegal
zh e n i ts' ee	illegal
z A gh OO z e	illegal
ts' aa k j A	illegal
dz I tL' e z O	illegal
ch aa w E ch' ee	legal
ts' a k a dz II	legal
sh E m i s o	illegal
ch' AA l EE z ee	illegal
ts aa tL o ch' aa	illegal
z AA tL A j oo	illegal
ts' E tL' OO ch' EE	illegal
zh AA tL z e	illegal
z a gh ii z A	illegal
j II k' AA z e	illegal
ch' OO gh e z I	illegal
ts' EE g oo s I	legal
sh ee x ee ts' OO	illegal
ch' EE L AA dz a	illegal
ch' AA X ts II	illegal
ch aa w ee ch aa	legal
ch E g e ch OO	legal
ch' ee b i z o	illegal
z AA d a zh a	illegal
zh II x E j EE	legal
dz aa L oo dz oo	legal
s i x E z O	illegal
ts a tL' a ch I	illegal
j oo b i ts e	illegal
j AA x E z AA	illegal
ch o w I zh I	legal
sh aa y oo z EE	illegal
ts' oo tL' OO j OO	illegal
dz ii d II ch ii	illegal
sh OO m A sh O	legal
j o w AA s EE	illegal
z O d OO dz EE	illegal
z A tL' i s II	illegal
j a dl AA z aa	illegal
s A tL e ts AA	legal
s EE g E dz O	legal
ts' I w z A	illegal
ch' AA b dz OO	illegal
sh ii L AA ch' a	legal
sh ii m i dz aa	illegal
zh AA k' ee sh i	legal
dz ee k' O dz EE	legal
ch' E k' OO ch' i	legal
sh oo dl EE z aa	illegal
ch I k' EE j A	legal
ts e dl E z II	illegal
zh a d e sh a	legal
zh ee m EE ch' I	legal
z O t i z e	illegal
s O k' AA ch' OO	illegal
ts a d AA z EE	illegal
ch' oo t' EE z OO	illegal
sh ee y I ts ii	illegal
sh o b i sh II	legal
s II n EE ts' A	legal
sh II k' aa ts' AA	illegal
ts O dl AA ts' ii	legal
ch OO b E zh A	legal
s II tL e ts' A	legal
ts o t AA ts' ee	legal
ts' ee gh a ts' A	legal
ts A k' ii zh a	illegal
ch' EE d i z ii	illegal
ch e d E z E	illegal
z I dl ii zh II	illegal
ts o n aa sh II	illegal
z I w I zh a	illegal
ts E t o z OO	illegal
z EE L e j oo	illegal
ch' A tL EE s OO	illegal
ts i b ee ts o	legal
ch' i X OO ts ee	illegal
j ee w j A	legal
z aa n i zh a	illegal
ts o m I sh oo	illegal
ch oo L I ch oo	legal
z O y AA zh AA	illegal
z a dl II ch' O	illegal
z OO d ch OO	illegal
j E x AA ch' oo	legal
sh aa d o ts I	illegal
dz ii k' EE zh E	illegal
ts' O X o z aa	illegal
ch' EE t a ts' ee	illegal
ts' ii x zh oo	illegal
dz II gh ts' A	legal
zh E tL' a j e	legal
s i g I dz OO	legal
j i dl I ts' I	illegal
sh EE l AA j I	legal
j e y e zh II	legal
sh ii tL' O sh aa	legal
z oo t zh E	illegal
dz ee gh EE ch i	illegal
z AA n e ts II	illegal
z E g o ch' ii	illegal
j ii t' O ts O	illegal
ch OO k' A sh A	legal
ch OO n a dz o	illegal
dz ii L EE ts' OO	legal
z O l ee s EE	illegal
ch' AA d dz ee	illegal
ch' a k' e j O	legal
ch E tL A s E	illegal
dz A t' E z oo	illegal
ch' EE X a ts' i	illegal
z A t' O z o	illegal
z o g II sh E	illegal
zh EE k aa zh E	legal
zh aa tL' II s a	illegal
ts' ii m j AA	illegal
s ee k EE z i	illegal
z A y OO s A	illegal
ch a l oo ts' I	illegal
z oo n ii ch' II	illegal
sh ii tL oo ch' I	legal
z A l a ts' ee	illegal
ch oo L I zh ii	legal
zh ii d s O	illegal
ts' II g ii sh e	illegal
ch AA gh E ch ee	legal
ts' A dl ee ch' EE	illegal
z II X A ch O	illegal
dz OO t O ts e	legal
ts' a gh z A	illegal
ch AA b s AA	illegal
s oo g aa j oo	illegal
z O k OO zh O	illegal
ts' E tL' EE z AA	illegal
z i gh EE ch' II	illegal
ch aa L I ch' I	legal
ts ii n OO dz A	legal
ts O w AA sh aa	illegal
s a dl II s EE	legal
j o k aa ch' OO	legal
ch' ii x z O	illegal
sh ii t' ch' E	legal
ts' II w I ts' O	legal
j aa b E sh oo	legal
z II d ee z e	illegal
j e gh I ts o	illegal
z AA t A z I	illegal
s O n I s i	legal
sh ee b EE ts' E	illegal
ts' II y O ts' OO	legal
s i gh EE ts II	legal
ts' AA w A ts ee	legal
z i k' A ch A	illegal
ts O dl ee s i	legal
ch' II t s I	illegal
j a g ts' O	illegal
zh II h i ts' EE	illegal
z EE dl oo j OO	illegal
ch' aa w j oo	legal
ts' ii tL' EE j a	illegal
ch' OO t AA ch' e	legal
ts' oo t' oo zh EE	illegal
ch II t' o j A	legal
j O tL EE ch' e	legal
ch' O k' II ch' E	legal
z e k' z a	illegal
ts' E L ee ch oo	illegal
sh o y OO j oo	legal
sh O X i ch O	legal
ch EE tL a s E	illegal
ts' I t AA ts' e	legal
j A t aa s I	illegal
ch' I b ee ch' A	legal
zh oo t i dz a	illegal
zh ii w EE zh A	legal
ts' OO g ts ii	legal
z II h a ts EE	illegal
zh EE x E z ee	illegal
dz I x oo s o	legal
ts ii k' oo s O	legal
ts' EE L o dz II	legal
dz o gh oo s o	legal
s II t' e z o	illegal
j O m A ts e	illegal
j ee X A j oo	legal
dz e dl II z I	illegal
s AA tL' ts' E	legal
ch E X OO ch' II	legal
z II h i ts AA	illegal
j ii b aa zh E	legal
j OO t' A sh e	legal
ts' OO l j ee	illegal
j ee l ee z a	illegal
sh O X E z O	illegal
z EE k A j ee	illegal
ts' oo d ee ts' OO	legal
ch oo w A ts' E	illegal
dz II gh E sh I	illegal
j e l OO ch E	legal
ch' II l II ch' o	legal
sh ee m oo ts' A	illegal
zh ee k' II ch' oo	legal
z o k OO ch' OO	illegal
ch' e g z A	illegal
ch ee w A ts' O	illegal
ts ee t z A	illegal
ch II b oo z e	illegal
s e n EE z AA	illegal
z i X oo ts' e	illegal
dz II d II ts' oo	legal
dz I tL EE ts' I	legal
ts' EE t' a j ii	illegal
dz oo m II zh AA	illegal
j oo b ch ee	legal
dz i tL oo ts OO	legal
ch i dl OO ch E	legal
ch ii m o s o	illegal
s o X o ts' e	legal
ts' A k' ii z EE	illegal
ts II l AA ch' OO	illegal
ts i m o sh E	illegal
ts o h O ch' EE	illegal
ts ee h OO ts I	legal
ts' EE tL oo z E	illegal
s o X A ch ee	illegal
ch' a d A j I	legal
dz I y AA ts' II	legal
ts' a tL' A z EE	illegal
j o l e z OO	illegal
ts AA dl I zh oo	illegal
z a t i j ee	illegal
j II g OO ts' a	illegal
z oo t I dz OO	illegal
ch I k' i sh II	legal
ts' aa dl ii z OO	illegal
ch' e m I dz I	illegal
sh II tL O j e	legal
ch' I tL o dz I	illegal
j a m a s O	illegal
zh e gh o dz a	illegal
s E tL' EE zh OO	illegal
j E l e sh aa	legal
ch' AA g sh O	legal
dz II n II sh i	illegal
zh a g aa sh ee	legal
dz E dl ee j E	illegal
ts ii l e sh O	illegal
z i k' E ts e	illegal
z oo L ts E	illegal
ts ii g ii ch AA	illegal
zh I k I ts II	illegal
z I w I sh a	illegal
j A w e ts' oo	illegal
sh i h o ch E	legal
dz I h E zh ii	illegal
ch i y OO ch' E	legal
zh o w i ts' AA	illegal
z OO L a ch OO	illegal
ch oo l O z i	illegal
zh II d e zh E	legal
ch' O t i ts ii	illegal
ts EE g a j a	illegal
dz a h o ts' AA	legal
j OO t' OO ch e	legal
zh o y z EE	illegal
ts a n oo dz ii	legal
z i d ee dz E	illegal
s aa dl II z oo	illegal
s o gh ch' I	illegal
sh E k e j E	legal
ts' i k' ii ch' e	illegal
sh ee l ii ch' II	legal
ts' o dl zh EE	illegal
j aa y oo ch' a	legal
ch' o dl O ch' AA	legal
s oo X i ch' ii	illegal
j oo x o dz oo	illegal
ts' AA x E ts' OO	legal
z O m zh ee	illegal
j AA g A z o	illegal
sh e y EE ch a	legal
j e dl A dz oo	illegal
zh oo tL' OO s ii	illegal
j A l j ii	legal
zh II X AA z oo	illegal
ts' oo b OO ch A	illegal
ch' ii h II j ii	legal
z I t i z E	illegal
ts' O gh AA ch' a	illegal
zh I m e z a	illegal
ch II tL EE zh AA	legal
z oo X A ch i	illegal
sh o m ii ts' o	illegal
z AA w I ts' oo	illegal
ts' o gh aa z o	illegal
dz e dl EE ch' II	illegal
sh a X sh II	legal
ts EE k' e ch' i	illegal
s ii L I j E	illegal
z e dl oo ts o	illegal
ch' AA m a ts' aa	illegal
ch' a h i ch' E	legal
z E h II z o	illegal
dz o t EE sh II	illegal
dz ii n O z e	illegal
ch' AA X EE ch' O	legal
ch ii w a ch' o	legal
z e k ee s OO	illegal
dz II tL' E ch' AA	illegal
dz e t ii ts' A	legal
j o d o ts' i	illegal
j I h i sh II	legal
ts' OO k' ii ch A	illegal
ch' oo tL' s o	illegal
ch' II tL' z II	illegal
ts' OO l ts aa	legal
z oo g I ch' I	illegal
s O l I z I	illegal
j i h o z oo	illegal
ts EE n z O	illegal
sh oo gh o ch' aa	legal
j i gh II z O	illegal
ch' II d ii dz II	illegal
z ee h ii z e	illegal
z A gh E ch EE	illegal
z aa gh EE ch' O	illegal
dz A k' e ch I	illegal
ts' O y ii ch OO	illegal
ch a k' ee z ee	illegal
ch i k' E zh EE	legal
dz e l A ch OO	illegal
ts' II m O ts' A	legal
ch a dl E dz OO	illegal
dz EE L I dz ee	legal
z OO w E dz i	illegal
z EE gh ee ch' aa	illegal
ch E k z aa	illegal
ts ee h aa zh aa	illegal
z oo x O s o	illegal
dz AA x E z o	illegal
ts I tL' EE sh E	illegal
sh O k OO sh E	legal
zh II b A j E	legal
j O y A ts i	illegal
sh AA t' o ch o	legal
sh i y i sh i	legal
ch O n EE z ee	illegal
ts a h e ts o	legal
sh e l O ch i	legal
ch' I L a z e	illegal
ts oo gh OO z O	illegal
zh aa m EE ts I	illegal
zh a d II zh OO	legal
z oo b A ch oo	illegal
sh II t OO ch I	legal
z i X E zh ii	illegal
s a tL' o ch' oo	illegal
s a d oo sh E	illegal
s ii k' o dz i	legal
ts e t O z A	illegal
ts' AA b ii ts ee	legal
dz AA t e ch' A	illegal
z OO w o s aa	illegal
sh OO dl ts' EE	illegal
ch i t' O s o	illegal
ch' EE g OO ts' OO	illegal
j aa g A zh II	legal
z ii h z I	illegal
ts o x dz EE	legal
zh o X i dz ee	illegal
s i t' ee j oo	illegal
z o X z EE	illegal
ts' EE k' OO ch' ee	illegal
ch ee y ii z a	illegal
z EE k' AA ts' ee	illegal
sh E b EE ch e	legal
j EE w AA ts OO	illegal
j e h EE j o	legal
ch o t o j e	legal
dz i dl ts' AA	legal
z EE y O zh ee	illegal
z ii d o ch' ii	illegal
j o t A ts' ee	illegal
z OO b A dz OO	illegal
j ee h i ts ii	illegal
z E d ii sh o	illegal
z i n ee ch' ii	illegal
zh AA gh e z oo	illegal
ts' a t I ts' II	legal
s aa X OO s oo	legal
sh e X O sh I	legal
ts' o tL' I s O	legal
ch' AA k ii j E	legal
sh OO w O dz A	illegal
s ee y oo z oo	illegal
z ee k' ee dz II	illegal
ch' a m ee z ee	illegal
ts' E b II zh oo	illegal
z i t ts' II	illegal
ch' OO m I ts ee	illegal
s I d ch' aa	illegal
z II gh E ch' ii	illegal
ch o l oo j i	legal
dz ii dl e z oo	illegal
s ii d II j OO	illegal
z oo tL' AA ch' O	illegal
z EE tL OO ch' E	illegal
ch ii gh i j ii	legal
dz AA gh o ch A	illegal
ch' o k' ee zh O	legal
z e y j aa	illegal
ch' ee l AA ts I	illegal
sh aa h z ii	illegal
ts' a k' ii s ii	legal
ts I y ii sh AA	illegal
ch ee t ii z e	illegal
zh E x I ch' AA	legal
dz a b A ts A	legal
ts' OO dl ee zh O	illegal
z E L s a	illegal
ts e n oo j ee	illegal
dz O t' o z OO	illegal
ch' E tL' oo dz oo	illegal
sh a h e ch' A	legal
zh I h ts' I	illegal
ts a b aa zh o	illegal
ts' ee t EE j EE	illegal
z e dl I dz II	illegal
z o X I ts' a	illegal
j o dl o zh A	legal
j I y ch' EE	legal
zh O k ii s A	illegal
ch' I tL' II zh aa	legal
ch' I gh ts aa	illegal
ts' II k OO s II	legal
sh OO w aa z I	illegal
ch I g O ts' II	illegal
z ee h O dz aa	illegal
zh II x A ts oo	illegal
s EE y ee s ee	legal
ts' I t' ts' e	legal
ts A k o zh aa	illegal
zh o tL' aa s a	illegal
zh E x j a	legal
z aa dl AA ts' A	illegal
ch i y oo s O	illegal
z ii b EE j E	illegal
dz OO w oo s AA	legal
ch' oo dl E z EE	illegal
ch' o n i zh EE	legal
z aa tL E z ee	illegal
z i dl zh I	illegal
ts oo t' e ts aa	legal
z OO g A zh a	illegal
s o k A sh EE	illegal
ts II k' e ts EE	legal
j II w AA s I	illegal
ch' i l a j oo	legal
dz a h I z aa	illegal
ts' II tL' O z ii	illegal
ts' aa d i ch' o	illegal
dz oo x ee j II	illegal
zh I tL e s ii	illegal
ts' aa n OO dz e	legal
z ee d ch e	illegal
j aa h a ch' AA	legal
zh e tL' oo z o	illegal
sh o t sh OO	legal
ts' EE w s a	legal
sh ee k I zh EE	legal
ch aa tL ee dz AA	illegal
sh i L O z i	illegal
ch AA b O ts' e	illegal
z ii tL' EE s aa	illegal
j ii gh II j ii	legal
j EE t' II sh ee	legal
z o b II sh AA	illegal
ts' O n aa ts aa	legal
sh aa m oo ch ee	legal
z AA k oo sh A	illegal
dz i n I j O	illegal
ts' EE y i ch' O	illegal
j O m e z e	illegal
sh I t' OO z a	illegal
ch OO n O z i	illegal
s E t' EE ts i	legal
j O y a z aa	illegal
ts I tL' O zh ii	illegal
s a t' sh a	illegal
j a L dz II	illegal
sh e t' A j e	legal
sh i g ee sh i	legal
sh II x I ch OO	legal
z e X oo j II	illegal
sh E t' z AA	illegal
j a tL ch' O	legal
z a b II ts' A	illegal
z e y z oo	illegal
z o h ee ch i	illegal
zh OO tL' oo zh EE	legal
z A L OO zh OO	illegal
ch' I tL' OO dz ee	illegal
ts o h ii zh O	illegal
s A l i dz II	legal
z e m a ts O	illegal
ch' a L i z AA	illegal
dz a l ii zh OO	illegal
ch' oo k ii j e	legal
dz E n I z EE	illegal
s o tL e ch' i	illegal
ch O l OO ch' ii	legal
zh aa b e s II	illegal
ts' OO X OO ts' i	legal
ch' oo b EE s ee	illegal
ts oo d e ch oo	illegal
z aa dl EE s I	illegal
dz II w ii ch' OO	illegal
z E w II dz i	illegal
ch' E t' e s O	illegal
dz EE L A ts A	legal
z ee l OO z i	illegal
j oo gh I dz E	illegal
ts AA w ee ch o	illegal
zh o h i ch' OO	legal
zh O x i ts' o	illegal
ch' A d I dz oo	illegal
z I d i j aa	illegal
z i y O ch' i	illegal
zh oo g aa dz E	illegal
s aa t A ch' ii	illegal
ts' O g OO ch A	illegal
ts' ee n aa z i	illegal
z aa t e zh E	illegal
z OO dl o ts E	illegal
ts' ii l ii z aa	illegal
j E k OO zh e	legal
dz ee tL' e ch OO	illegal
ch ee m o z AA	illegal
dz ee k OO s o	legal
dz ee b ii zh i	illegal
ch' oo L II z EE	illegal
ch OO gh O z II	illegal
ch aa tL' AA j E	legal
z OO X aa z E	illegal
sh e w zh a	legal
ch AA tL' a ts' O	illegal
ch' a n A z E	illegal
zh ii d ch e	legal
s AA X O sh O	illegal
ch oo h o z II	illegal
s A dl II ch O	illegal
ts' EE X A z EE	illegal
j i dl EE j i	legal
zh EE y OO ts' e	illegal
ts aa dl ee z II	illegal
ch' o y OO ch E	legal
ch' E d EE dz a	illegal
s E tL' a ch' ii	illegal
sh I m a s OO	illegal
z A g A j i	illegal
z OO h ii ch ee	illegal
z OO x i sh OO	illegal
z a g A s I	illegal
ch' E t' I ch' i	legal
ts a x OO ts I	legal
sh ee n e z II	illegal
j i x I ts E	illegal
sh oo y E dz O	illegal
sh EE dl ii s E	illegal
ch I w i j A	legal
ch' e y II ts i	illegal
z a dl I ts aa	illegal
ch ee d o zh a	legal
ch O n dz o	illegal
ch aa n i z E	illegal
sh oo g II ts II	illegal
z I k oo s e	illegal
ts E g II ch' II	illegal
ts' ii k' ee dz OO	legal
zh e L a z A	illegal
ch' E m O z i	illegal
dz ii b AA z oo	illegal
sh E t oo z ee	illegal
zh ee tL' OO j II	legal
z e d EE ts aa	illegal
zh oo k' a s AA	illegal
j aa t' ee ts e	illegal
z oo g EE z E	illegal
sh oo n e ch' II	legal
sh II k' A ch I	legal
sh a y ii sh I	legal
ts oo k ee z e	illegal
ch' E tL ee zh ii	legal
dz e t' e ts' E	legal
z OO k' oo j II	illegal
zh A gh I dz OO	illegal
sh EE gh o ts' EE	illegal
ch ii n z e	illegal
dz I tL' I ch o	illegal
ch O k' a ts' OO	illegal
z ii m AA j EE	illegal
ts' ii x oo dz O	legal
sh I tL' E z ee	illegal
ts ee dl II dz i	legal
ts I m zh I	illegal
ch ee d A dz I	illegal
sh I g s E	illegal
ts' E n ee dz I	legal
j II t' A z OO	illegal
ts' ee X ee zh EE	illegal
z A l aa s oo	illegal
ts aa x dz ii	legal
ts' ii k oo sh EE	illegal
dz AA y i ts o	legal
sh E k' e z I	illegal
dz i k II s E	legal
j AA b A s i	illegal
sh ee dl A ts' ee	illegal
j o k' O z e	illegal
sh OO dl e ch II	legal
z O h A ch I	illegal
z O L AA dz i	illegal
dz II h oo ts' OO	legal
ts' O k A ts' a	legal
s o t' o z a	illegal
ch' a t' sh o	legal
z i b OO zh ii	illegal
ch II gh OO j EE	legal
z II g e sh o	illegal
z e b oo zh A	illegal
s ee gh a j i	illegal
zh O L oo ts' OO	illegal
dz aa gh aa ch' OO	illegal
s E x O ts O	legal
s AA w o dz oo	legal
ts o n o zh I	illegal
sh ee X e z OO	illegal
s I b OO s ee	legal
z I tL i s aa	illegal
ts' I dl i z aa	illegal
z O dl z i	illegal
ts' AA h ch ee	illegal
ts' e n A ts' i	legal
j OO n OO s EE	illegal
ch' I n A s a	illegal
ts II gh sh O	illegal
dz E d aa dz aa	legal
ch' AA l I z OO	illegal
dz A L ii ts I	legal
sh o g oo dz I	illegal
dz OO tL II zh a	illegal
z OO t aa ts oo	illegal
z OO k II ch ii	illegal
zh O L aa z II	illegal
ts' II dl OO z II	illegal
ch AA g AA ts' O	illegal
ch' oo X e zh aa	legal
ts' EE L o dz A	legal
dz o d zh AA	illegal
ch' E n o zh AA	legal
zh I t e s a	illegal
ch O n E ts O	illegal
z EE h A z E	illegal
ts' aa t' II s II	legal
ts II gh A zh a	illegal
ch e gh A ts EE	illegal
sh e tL' EE j o	legal
dz i x A dz a	legal
dz E g ee zh oo	illegal
dz O t aa ch' ii	illegal
ch OO n EE zh O	legal
sh ee k' ee z E	illegal
ch e n dz O	illegal
ch' ii m E ts' A	illegal
ts' aa g zh EE	illegal
sh A b ee dz AA	illegal
z aa tL' i z OO	illegal
sh o L E ts O	illegal
s OO t aa dz e	legal
ch' O x o ch' ee	legal
j i tL' ts' II	illegal
zh I dl I ch' e	legal
z EE X AA ts' A	illegal
ts' OO t' j oo	illegal
z a y i ts E	illegal
z ii d I ts ii	illegal
ts O m E ts' a	legal
z o m ts' ee	illegal
s A m oo ch aa	illegal
s e L aa zh I	illegal
ch ii g e z ii	illegal
z ee tL' e zh ii	illegal
dz AA w II dz O	legal
ts' o dl e ts' e	legal
z ee n o z OO	illegal
zh o g e z AA	illegal
dz A b E zh A	illegal
ch' II gh e z AA	illegal
j e n E ts' I	illegal
j ii X EE ch i	legal
ts' ee t' e sh OO	illegal
ts I gh A zh O	illegal
ch a L ee ch' i	legal
z a tL aa ts e	illegal
dz i m AA zh ii	illegal
zh I X EE z AA	illegal
dz A y o z ee	illegal
z e X AA ts I	illegal
sh E tL AA ts' a	illegal
s OO X I sh oo	illegal
sh ii tL I ch' ii	legal
s i L O ts oo	legal
ch EE k' EE ch' AA	legal
ts' ee tL oo dz E	legal
ts ii b ee sh o	illegal
ts i h OO j O	illegal
ts' ii dl II ch A	illegal
dz II X II s OO	legal
z o L I z E	illegal
ts EE m II z A	illegal
z A tL EE z OO	illegal
j O l e ts' o	illegal
ch ee t' ch e	legal
sh O m aa sh a	legal
ts' E k a sh i	illegal
z EE n O z EE	illegal
zh II tL' OO s A	illegal
ts oo g EE j a	illegal
ch II m I zh aa	legal
dz EE gh E ts a	legal
ts aa t e dz O	legal
s EE dl ee dz oo	legal
s ii t AA zh aa	illegal
ts oo h i s i	legal
z aa l OO ch' EE	illegal
dz a k ii ts ee	legal
z e b A ts' ii	illegal
ch' ee l I sh e	legal
ts' I n o sh E	illegal
ch OO w o z ee	illegal
j a tL' ts' EE	illegal
zh o k ee zh II	legal
sh A x A j i	legal
ch' E dl EE z o	illegal
dz ii b AA sh a	illegal
s II tL' zh i	illegal
sh O k' o ts' A	illegal
ts' II h A ch II	illegal
z I y AA dz AA	illegal
dz o k' O ch' aa	illegal
dz II b o ch aa	illegal
j I tL' i z ii	illegal
zh o d o s I	illegal
ts o x dz ee	legal
z i dl II s i	illegal
z i b AA zh aa	illegal
ch' I k' E j II	legal
s O w aa z ii	illegal
ch' O t a zh I	legal
ch I g i zh e	legal
ch oo h e zh aa	legal
ch AA gh O s aa	illegal
j aa t' OO s E	illegal
z o x II z a	illegal
ts ii x ts OO	legal
j a L a z II	illegal
ch' OO tL i ch I	legal
ts' o tL oo z II	illegal
ts' e gh EE z I	illegal
s OO d a sh i	illegal
zh A d a dz E	illegal
sh ii x aa ch O	legal
sh oo n E z ee	illegal
ts' o d zh ee	illegal
ch a h i j o	legal
ch' A d OO s I	illegal
ch e b aa zh II	legal
j ee w ii ts' A	illegal
sh o m E dz AA	illegal
ts' i b ii ch i	illegal
s AA l II ts' aa	legal
dz aa x A ts OO	legal
dz A tL II dz I	legal
s E h ii dz a	legal
z OO tL O zh OO	illegal
dz ii k' ii dz II	legal
ts i gh ee ts aa	legal
ts a k' aa sh i	illegal
s EE tL ii j ee	illegal
dz o k AA ch' A	illegal
s II tL oo ch' I	illegal
zh OO tL j oo	legal
z e X oo dz AA	illegal
ts' O x e z e	illegal
z oo tL EE sh I	illegal
ch' O L E ch' II	legal
sh ii dl AA j ee	legal
ts' E t a s e	legal
s e dl I ch ee	illegal
zh EE n OO s ii	illegal
z AA k' aa zh i	illegal
ch' e m o ts' i	illegal
j I t II z AA	illegal
sh i w A ch A	legal
ch' O L aa ch II	legal
ts ii y O ts A	legal
z O n aa zh A	illegal
ts' EE m I s ee	legal
sh oo y E s e	illegal
ts' II n E zh aa	illegal
z ee L e ch o	illegal
s o d dz i	legal
sh aa X A dz ee	illegal
z oo tL' aa dz OO	illegal
ch a gh aa z AA	illegal
ch' E tL i dz oo	illegal
z o x EE j oo	illegal
ch' EE b O z O	illegal
zh AA t i ch a	legal
ch' ii tL II ch OO	legal
dz AA d I ts OO	legal
dz OO h aa sh e	illegal
dz EE d ii j ee	illegal
z AA w z e	illegal
sh ii X ii ts' aa	illegal
s ee X I ch' A	illegal
z aa n OO ts' i	illegal
ts' A n AA j e	illegal
zh A dl j i	legal
zh E L aa s a	illegal
j i w ee ts aa	illegal
ts' A tL aa j aa	illegal
z aa n AA zh oo	illegal
z OO d ii s i	illegal
ts A x ii ch i	illegal
z ee n E j O	illegal
j OO x I s aa	illegal
j i gh e sh e	legal
z aa t a sh E	illegal
ch i tL z i	illegal
ts I g II ts' o	legal
z i w i j ii	illegal
s ii dl I j aa	illegal
sh oo gh o z oo	illegal
zh ee w aa zh ee	legal
dz O t' ts' OO	legal
ch' e b ch' OO	legal
j A dl O ch' O	legal
ch' I h e ch oo	legal
ch' AA d II ts' O	illegal
s a x OO s E	legal
j EE gh ee s aa	illegal
ts EE x oo ts e	legal
z i k dz a	illegal
j e x sh EE	legal
ts OO L O z oo	illegal
s OO w EE ts' aa	legal
z ii m a dz ii	illegal
s ee dl o ch OO	illegal
ch OO y j II	legal
ts' EE w a zh i	illegal
j ii X A ch E	legal
ch e t' a s E	illegal
sh aa b ii dz I	illegal
sh oo L AA ch OO	legal
ts II tL' a ts A	legal
j OO tL' I ch oo	legal
ts' oo tL' o ts A	legal
ch A k' i ts ee	illegal
ts AA m AA ts' i	legal
ts A g OO ch' oo	illegal
s AA h aa ts o	legal
s ee k' i dz a	legal
ts' O tL' EE s OO	legal
sh i x ii z aa	illegal
ch ii b ii sh e	legal
sh O k' ee j EE	legal
s E k OO z A	illegal
zh OO l II zh E	legal
s OO X AA ch oo	illegal
s AA k' o ts' o	legal
ch e t O z EE	illegal
zh A t' A j O	legal
dz e k' OO z AA	illegal
dz o t' A sh a	illegal
ts' ii d AA ch' o	illegal
ch A w dz I	illegal
z a d AA zh ii	illegal
zh a d A ts' ii	illegal
j a m O ch' EE	legal
dz EE y e dz OO	legal
ts aa x OO ts aa	legal
dz e k zh OO	illegal
sh EE L o ts' OO	illegal
ts' o w o z e	illegal
ch a t e ch' e	legal
dz ee x OO sh aa	illegal
z ee h OO sh o	illegal
j E L a ch II	legal
j a l OO dz AA	illegal
z A tL' II s oo	illegal
zh II t' ee z O	illegal
j OO l o s AA	illegal
j i x o z e	illegal
z i l e sh ee	illegal
s aa L o ch' O	illegal
ch' i t ee ch' o	legal
ch' ii d OO ch' E	legal
ts oo k aa dz EE	legal
z O n E ts ee	illegal
sh e l O ts' AA	illegal
ch' A d EE ch o	legal
ch' a x o z o	illegal
j ii t' oo ts' EE	illegal
s O tL' i s a	legal
sh O l o z o	illegal
sh I x aa z O	illegal
j I X j e	legal
ts EE dl i z O	illegal
ch' AA tL' e sh II	legal
ts' ee dl a z i	illegal
ch E b I j OO	legal
j OO d i z E	illegal
ts i g O dz e	legal
z i k' i s ii	illegal
zh i y EE ch' i	legal
z oo n aa ch o	illegal
ch' ee gh oo zh oo	legal
ch AA l A ts' ii	illegal
sh A tL' ts' aa	illegal
j E tL' I ch O	legal
dz E k aa ch' II	illegal
ch E k' o ch AA	legal
ch OO tL AA ch II	legal
sh AA x o z a	illegal
s a t s I	legal
j O g ee ts ee	illegal
s EE x o ts E	legal
zh ee tL AA sh a	legal
zh O k' o zh e	legal
j i y O dz a	illegal
z OO g aa dz OO	illegal
ch AA d AA sh E	legal
ts ee m e zh e	illegal
dz oo b ee dz E	legal
ts A t o sh E	illegal
z oo t o z ee	illegal
ts EE d e s ee	legal
z i k ts' O	illegal
ts' aa X II z E	illegal
ch ii tL' a dz ii	illegal
ts' e d O z o	illegal
z ii h i dz o	illegal
zh II L AA ch E	legal
s o t' O ts A	legal
ts E gh OO dz EE	legal
ts' A g ii z AA	illegal
z ii d j EE	illegal
ch EE b e zh II	legal
z i t' e s II	illegal
zh AA L z o	illegal
z ii gh aa ch' A	illegal
ch ee h AA s A	illegal
dz e y II j ee	illegal
ts e h a ch' oo	illegal
ch E X aa j e	legal
sh i t' II z ee	illegal
j a n ii ch oo	legal
ts aa b ee z i	illegal
ts' O h AA dz I	legal
ch a g aa dz a	illegal
ts a h O ch' E	illegal
s E t E j aa	illegal
z II w AA ts' oo	illegal
sh ee t O ts' o	illegal
ch ee l I ch' aa	legal
j ee g sh EE	legal
z i t A ch e	illegal
z oo m oo ts' OO	illegal
j o l ii s a	illegal
zh aa tL z o	illegal
ch' oo gh EE j a	legal
sh I X a z aa	illegal
sh OO g ii j e	legal
dz ee k oo ts aa	legal
sh a l II ts aa	illegal
dz AA t' OO z II	illegal
ch' OO k ii zh o	legal
ch ee k ch' A	legal
z aa m o ts aa	illegal
dz E t' o z oo	illegal
ch AA tL aa j I	legal
ts I x aa ts a	legal
ts' e x ee s o	legal
z O b o j II	illegal
ch' EE tL ee ch i	legal
ts ii y E sh EE	illegal
dz II l OO j oo	illegal
ch A tL i ch' i	legal
zh I t EE ts I	illegal
zh AA tL ii j A	legal
ch' a w II s E	illegal
j EE k aa j i	legal
z E gh i dz O	illegal
sh EE t' o zh o	legal
z AA b oo j e	illegal
z e tL' e s AA	illegal
dz e tL' EE z A	illegal
z ii y OO sh II	illegal
s ee b zh E	illegal
ch' I h dz OO	illegal
ts ii k' z E	illegal
sh ii g A dz OO	illegal
j ii k EE z o	illegal
dz AA L I ch' AA	illegal
dz i L E ts' OO	legal
sh aa t i ts o	illegal
dz ee gh ee ch aa	illegal
sh a tL e ts' ee	illegal
ts' EE n AA zh I	illegal
s oo L II s AA	legal
j e X AA ch OO	legal
j E dl o sh ii	legal
ch' o m oo z OO	illegal
zh oo w o zh E	legal
ts i k' O j o	illegal
zh oo l e z A	illegal
s O tL o sh E	illegal
s a y i dz I	legal
z aa m A z o	illegal
dz O tL' E ch aa	illegal
j o t AA z e	illegal
j OO X OO z i	illegal
z I t' ee z oo	illegal
z OO X o z AA	illegal
dz a tL a ts' II	legal
sh ii t e j O	legal
ts' oo l z o	illegal
ch I b I j o	legal
ts e k' OO s i	legal
zh OO t' j oo	legal
sh OO X II z O	illegal
dz a X a ch AA	illegal
z ee h OO dz a	illegal
j AA L aa j EE	legal
dz I tL' OO z i	illegal
s A d i dz o	legal
ch' a h sh AA	legal
zh I k II ts A	illegal
j E tL EE s O	illegal
s II g II j E	illegal
s EE y ii ts II	legal
sh aa tL zh e	legal
z a w I zh OO	illegal
ch' a d OO j i	legal
dz A t' aa j oo	illegal
zh a k OO s e	illegal
s E l I ch AA	illegal
dz a gh II dz I	legal
z oo dl z EE	illegal
ts' o w ee ch' II	illegal
j a n I zh ii	legal
zh aa k a j O	legal
sh a tL II z II	illegal
zh ii tL' AA ts' II	illegal
ch' E t aa z EE	illegal
ts' ii b a ts' O	legal
s i g ii zh O	illegal
ts' oo g aa j O	illegal
zh EE dl OO ts' O	illegal
z oo t' O z O	illegal
z oo b OO ch' EE	illegal
ch AA k II s i	illegal
ts e g e ts' a	legal
zh ee tL II ch a	legal
s e tL I ts' OO	legal
sh EE d e ch i	legal
z E w o z II	illegal
dz aa x II dz I	legal
ts' ee n E dz i	legal
dz A t' O j OO	illegal
ts' EE t a zh O	illegal
j o h II z EE	illegal
j II d ch' a	legal
z II k' ts' a	illegal
ts a dl E z oo	illegal
s aa gh a sh EE	illegal
s o d II dz e	legal
s AA tL s e	legal
zh oo X j EE	legal
j ii gh EE ch OO	legal
s o g AA zh oo	illegal
ts OO L z ii	illegal
zh o d ee ts i	illegal
ch' II d ii ch' E	legal
dz i t' II s ee	legal
ts' E tL' o ch' I	illegal
s EE tL' ee dz I	legal
ch I l a ts EE	illegal
ts II b AA ch A	illegal
dz ii d E dz E	legal
zh i tL' e ch I	legal
sh OO x OO ch E	legal
z a n i ts' oo	illegal
ch' ii tL i ts oo	illegal
ch' E X o ch' E	legal
dz a w o ch II	illegal
zh aa t A dz OO	illegal
j AA gh E sh EE	legal
ch e h aa s E	illegal
j o g A s ii	illegal
ch' EE k e ch' oo	legal
sh oo X E ts OO	illegal
ch a w EE z O	illegal
dz EE gh oo s II	legal
ch' a L ee z AA	illegal
ch e y OO j EE	legal
sh E t' oo ts' AA	illegal
dz oo b EE zh i	illegal
zh e w ii ch AA	legal
z ii g AA z ee	illegal
ts aa h A ts o	legal
ts' ee X e ch EE	illegal
ch aa y O ch o	legal
z A g O ch' e	illegal
z aa w OO dz ii	illegal
z A tL EE s o	illegal
z O l a ts oo	illegal
ch AA w II ch A	legal
ts' e k O zh i	illegal
z A l o j aa	illegal
ch' e m EE j I	legal
s oo l AA ch' EE	illegal
dz a l a z a	illegal
s ee tL' ii sh E	illegal
ts ii y O zh II	illegal
ts' AA m II ch' OO	illegal
ch AA dl aa ts' I	illegal
ch' ee x ii sh E	legal
ch oo t' ch I	legal
zh aa t I z A	illegal
dz oo g AA dz o	legal
ts' II k' A ts ii	legal
dz a l EE s O	legal
dz e t ch' ee	illegal
s II t' II ts II	legal
z o g oo ch' ii	illegal
sh o gh aa zh aa	legal
s ii tL' i zh o	illegal
dz OO n AA ts' a	legal
ch' AA x EE ch' I	legal
ch i x OO dz EE	illegal
zh a l E z EE	illegal
ts II h ee sh a	illegal
ch' II t' ii dz AA	illegal
ts e g A ch' E	illegal
ch EE tL' E ch ee	legal
j aa d zh ee	legal
ts' AA L EE sh O	illegal
dz aa b A ts A	legal
ts' A b EE s E	legal
ts' ee m o ts II	legal
ch II X i j oo	legal
dz ee w I z A	illegal
ch' OO L ee ch' I	legal
z aa k i zh OO	illegal
sh i X I sh a	legal
ch' ii t' E sh aa	legal
sh aa h a s E	illegal
dz I tL' ee ts oo	legal
s E gh OO z II	illegal
dz ii tL' o s ii	legal
j oo k i ch' E	legal
ts ii k' E zh aa	illegal
ch o m E z ee	illegal
dz E m II dz ii	legal
ch' a k' EE ts' e	illegal
j e L I s i	illegal
j E t' ii zh OO	legal
sh ee dl AA ch a	legal
z O k OO j I	illegal
z e L I ts' I	illegal
z oo l OO z i	illegal
sh ii X ee z i	illegal
j II tL E s OO	illegal
ts o h e zh A	illegal
z ee tL O dz O	illegal
ch II dl a zh AA	legal
ts i tL' A sh O	illegal
j OO k' E z e	illegal
dz ii t AA s E	legal
s I d ii ch' a	illegal
s E dl o ch ii	illegal
ts I t' AA ch a	illegal
j AA L AA ts' ii	illegal
sh I t i s I	illegal
ts o gh dz E	legal
sh EE k i j A	legal
s oo t oo dz A	legal
z II h o ts' e	illegal
sh i h OO z O	illegal
ch AA tL' e ts' E	illegal
dz i t AA j AA	illegal
dz OO tL' A dz II	legal
ch ii w OO j aa	legal
dz II d O z a	illegal
sh o dl o ts' I	illegal
sh a n oo j OO	legal
j I d aa s ee	illegal
ts EE L A ts' ee	legal
s ee L II ch' ii	illegal
dz a t' AA z ii	illegal
z ee tL' ee ts' OO	illegal
ch o k aa ts' ii	illegal
ch e X ii ts' II	illegal
dz O t' ii zh i	illegal
zh II w z II	illegal
j II k' I s ee	illegal
dz EE k' OO ch OO	illegal
ts i k O ch a	illegal
s O g O z aa	illegal
s o x E sh O	illegal
ch' aa tL II sh o	legal
ts' AA x AA sh A	illegal
j o d o z a	illegal
ts' i h oo j ii	illegal
dz I h a j aa	illegal
ts' ii gh e z O	illegal
dz A X EE ch A	illegal
ch' II k AA z oo	illegal
ch a n e ch' ee	legal
z a w i ts II	illegal
ch aa w z I	illegal
z AA l o dz A	illegal
zh o g ii ts' EE	illegal
s oo t' EE z i	illegal
z OO m a ts' ii	illegal
zh e t ch' E	legal
zh a h O z a	illegal
s A tL i ts II	legal
ts ee X a j II	illegal
dz OO x a ch' ii	illegal
ch oo k ts ee	illegal
ch ii k' i j EE	legal
sh ee X ii z O	illegal
z A dl EE j OO	illegal
z AA gh sh II	illegal
j O gh AA ch O	legal
ch ee t' oo dz ii	illegal
j A x OO ch oo	legal
j A m II s i	illegal
sh aa tL o zh EE	legal
ts' E x e ch O	illegal
j O k ii s OO	illegal
ts A k' O ts ee	legal
sh oo b E zh AA	legal
j e x aa ch' EE	legal
ts' ee w oo sh A	illegal
z I t' EE z OO	illegal
s ee h o ts' AA	legal
ts aa y e ch' EE	illegal
zh EE g i ch' OO	legal
sh OO tL' o dz A	illegal
ch' e l j aa	legal
ch i b A dz ii	illegal
z aa l o dz O	illegal
s O tL zh aa	illegal
z o t O sh A	illegal
ch' ee gh O ts' O	illegal
z AA g a z AA	illegal
z I m II ts' E	illegal
s O k a ch o	illegal
z AA n aa z O	illegal
sh i L II ch I	legal
zh aa tL I j A	legal
j a L o s o	illegal
dz a t' II ch A	illegal
z ee k e ch ii	illegal
ch i k' I ch' aa	legal
z e tL II ts' i	illegal
sh a gh oo ch ii	legal
j EE dl a ts' o	illegal
j E t' e ch i	legal
z e m E zh oo	illegal
s E X a ts' oo	legal
ts' oo k II zh e	illegal
ts' ee h AA sh AA	illegal
dz II n AA ts a	legal
s ee d A zh o	illegal
ch' II h ts II	illegal
sh i h oo ts a	illegal
ts' aa n EE ts aa	legal
ts O h II sh OO	illegal
ts II k EE ch' a	illegal
ch e tL a ch' O	legal
ch E b zh e	legal
j E d I ts' AA	illegal
z ii d z O	illegal
dz a tL' i s EE	legal
ch i g I ch' a	legal
ts i h ee z AA	illegal
ts' AA g I ts ee	legal
ts II gh i ts' e	legal
ch ii k AA ts' A	illegal
j II y a dz e	illegal
dz I dl i z ii	illegal
zh O X AA j A	legal
dz I l I z oo	illegal
j O g OO sh EE	legal
j ee d AA ts EE	illegal
s ii y ts' aa	legal
ch' EE X EE ts' I	illegal
s II m EE ts' OO	legal
ts ee d e ts' e	legal
j O t dz OO	illegal
ch' i k a ch OO	legal
sh II m E ch' aa	legal
j AA b A sh I	legal
ch ii L i ts' e	illegal
z ee k o zh E	illegal
z i gh e ts' i	illegal
ch' OO n a dz aa	illegal
zh ee dl I s AA	illegal
ts e dl ii ts' oo	legal
dz ii gh I z II	illegal
ts' OO n e ch' ii	illegal
s aa dl I j o	illegal
j ee k II dz OO	illegal
z e L i ts' e	illegal
ch' O dl OO ch i	legal
s ee gh e ch E	illegal
ch E n I dz AA	illegal
z oo g EE ts' E	illegal
z EE h II z ii	illegal
dz a tL' A z ee	illegal
s oo h zh OO	illegal
dz i w A ts' i	legal
ts o m A ch e	illegal
sh oo dl j A	legal
sh EE gh a ch' oo	legal
z oo y i j ii	illegal
sh e tL EE ch' e	legal
ch aa w I dz E	illegal
ts OO L EE z e	illegal
j i m z i	illegal
z oo d o z ee	illegal
z A l sh e	illegal
ch' A b e j o	legal
z ii k' e j II	illegal
z AA x i z i	illegal
sh aa g ee zh e	legal
zh A b ts' ee	illegal
z A h II ch ii	illegal
sh i tL A sh E	legal
j ii t o dz ee	illegal
z O gh ee dz O	illegal
zh a x II ch II	legal
dz A b AA zh ii	illegal
dz A x ii dz o	legal
ch O d oo ts' ii	illegal
s o t' O ch' ee	illegal
z ee gh AA ts EE	illegal
z a k' oo ts' a	illegal
dz AA dl ee ch' A	illegal
sh aa b AA sh I	legal
ch' o dl a s O	illegal
ch' ee t' E dz i	illegal
z A w e sh AA	illegal
ch e t' II sh O	legal
s OO y ii ch A	illegal
s i m ch' O	illegal
zh A x E zh i	legal
z O d O ch I	illegal
s A n e ts' A	legal
s ii h AA z AA	illegal
z ii tL A j II	illegal
j E h O dz OO	illegal
ts A t' A dz ee	legal
ts' i n a s O	legal
zh A w ee dz AA	illegal
zh oo b ch O	legal
z o w AA j o	illegal
z ee X A z E	illegal
zh O w OO zh a	legal
z AA dl s EE	illegal
s e y II sh e	illegal
ch' aa n aa z OO	illegal
ts' e y o j aa	illegal
ch i t ee ch' O	legal
zh e L ee z oo	illegal
dz o n z AA	illegal
dz o m aa sh aa	illegal
ch' e gh a z EE	illegal
z i h ts aa	illegal
ch ee t' EE ts' a	illegal
z I d I ch E	illegal
s O y AA z ee	illegal
z II gh ts' II	illegal
dz a w o j I	illegal
z ee tL I ts i	illegal
ch' a l OO ch e	legal
sh OO dl ee j A	legal
ch' ee l oo z O	illegal
ts' ii h i ts' II	legal
ch' ii X II z OO	illegal
ts' aa b E z E	illegal
zh OO l ts' o	illegal
ts' i gh EE sh O	illegal
ch e dl O j EE	legal
ts A w II ts A	legal
ch A m II z O	illegal
ts' e b I s ee	legal
sh AA tL O s i	illegal
ch' oo n e sh E	legal
dz ee t' EE j o	illegal
ch a k' ts' i	illegal
ts aa x OO zh a	illegal
ts a tL' II ts' aa	legal
z o n OO dz ee	illegal
sh EE y i ch o	legal
ts aa m aa s E	legal
zh oo x aa s ii	illegal
j A L II s AA	illegal
sh EE l O j ii	legal
z A L ii sh ii	illegal
j e x dz II	illegal
ts' oo g i ch' I	illegal
ts aa t ee z ii	illegal
zh OO l I j a	legal
z ii d EE z i	illegal
ts A gh O sh oo	illegal
s AA tL' e j ee	illegal
j a gh a sh o	legal
s II g o ch a	illegal
dz II n II ts I	legal
sh e x aa s e	illegal
ch' ee t' I ts' aa	illegal
ts' ii t O dz II	legal
zh A y oo sh A	legal
s AA h II ts' E	legal
s oo m sh oo	illegal
z e dl II ts' I	illegal
dz AA L o z AA	illegal
zh i g AA ch' e	legal
ts ii x ii ts EE	legal
s ee x ee sh I	illegal
ts' o n z AA	illegal
zh EE h A s II	illegal
ch OO n E j AA	legal
s I X o ts' oo	legal
sh EE k EE dz OO	illegal
zh II y OO z e	illegal
j i d oo j E	legal
ts E m ii s AA	legal
j i tL' o sh O	legal
z i d I z ii	illegal
s AA x aa s A	legal
zh i k' AA j o	legal
ch' O n E ch A	legal
ch' aa k' EE j A	legal
dz E h ii dz I	legal
dz ee t E ts ii	legal
ch' aa y II dz a	illegal
s AA t i ch i	illegal
ts i m ee ts OO	legal
z ii h A s OO	illegal
j A tL' I dz e	illegal
ch' ii y oo z E	illegal
j aa t EE z ii	illegal
dz o m EE sh E	illegal
dz ee y AA z oo	illegal
ts E t i ch' I	illegal
s a h ii zh EE	illegal
j ii b E sh A	legal
s EE x i z a	illegal
j A h A ts' ee	illegal
dz a g ee zh a	illegal
ts EE dl E ts' OO	legal
z II w aa zh EE	illegal
ts' EE b oo zh O	illegal
s ee n OO dz EE	legal
sh II k' oo ch e	legal
ts O d zh a	illegal
ts e X O dz I	legal
ch' ee t e dz I	illegal
j II L E ch' aa	legal
z e n zh OO	illegal
ch o t' OO zh o	legal
sh AA y a zh OO	legal
ts' a tL' o sh E	illegal
s o t AA dz ii	legal
ch II tL' e ts' A	illegal
s AA y OO ch AA	illegal
zh e g o zh aa	legal
ts' II t' ii z OO	illegal
sh E d ee ch' O	legal
s AA L A ch e	illegal
ts ii h II zh oo	illegal
ts' AA k e zh EE	illegal
ts a k a ch' AA	illegal
ts e m EE sh AA	illegal
ts' I b z aa	illegal
j oo t OO ch OO	legal
sh ii w aa z ee	illegal
sh ee w o j oo	legal
sh II n o dz oo	illegal
j II L o ts' i	illegal
z E b EE ts' ii	illegal
zh O k' s I	illegal
zh i L aa ch' OO	legal
z a y aa sh i	illegal
ch' II g EE z O	illegal
z EE t oo ts EE	illegal
j O w I ch' aa	legal
sh ee n ch i	legal
ch' A tL' o z AA	illegal
sh aa dl OO zh aa	legal
dz EE dl a z AA	illegal
ts OO b E dz EE	legal
zh O y II ch o	legal
ts EE w O dz I	legal
ts' II dl ee z I	illegal
zh ee d ch ii	legal
j ii dl E sh a	legal
j AA w o z E	illegal
ts' ii t ee j O	illegal
ch' e X oo s EE	illegal
ts e dl a ch o	illegal
j OO X ee zh oo	legal
dz A k aa dz ee	legal
dz OO g aa s E	legal
ts' AA k a s I	legal
ch' oo d EE j EE	legal
ts ii L a sh o	illegal
z I tL' A ts AA	illegal
zh A gh AA sh E	legal
ts' A g O ch O	illegal
sh EE tL' z e	illegal
z A n e z e	illegal
z A tL ee sh A	illegal
zh II y A ts aa	illegal
j aa x ts' ee	illegal
ts oo t' ii zh ee	illegal
ts' AA t' o ts' OO	legal
ch aa tL' aa ts' ee	illegal
ch e gh AA z e	illegal
zh o n I j I	legal
j e dl OO j A	legal
z e gh E z ee	illegal
z e X i dz i	illegal
z O m EE s I	illegal
ts' OO w a ts' AA	legal
s O n O j a	illegal
ts ee l ts' i	legal
zh I dl ee z ee	illegal
dz i dl II z II	illegal
zh ii g AA zh II	legal
ch o gh ts OO	illegal
ts OO X i ch' I	illegal
ts O h OO s i	legal
dz O X e ch' e	illegal
j e dl AA sh ee	legal
ch i k aa ts' aa	illegal
j E x EE ts o	illegal
sh OO tL ii s ii	illegal
dz OO X i j e	illegal
ts' A k E ch E	illegal
sh O t ii z i	illegal
ch' OO tL I z aa	illegal
ch' aa n s O	illegal
z o dl I ch A	illegal
dz oo l aa z ee	illegal
ch O h ii z E	illegal
dz AA n ee ch' oo	illegal
ch O X EE ts' oo	illegal
dz ee l I ts' oo	legal
sh aa m I z i	illegal
dz ii n II ch' EE	illegal
ts a d A sh EE	illegal
ts OO tL' I ts' ee	legal
s e k I sh ee	illegal
zh II t' z E	illegal
z OO l O s ii	illegal
z A L a z II	illegal
j II t' ee ts i	illegal
ts' II dl o z ee	illegal
s I d E ch O	illegal
ch AA m i z o	illegal
j EE dl O s E	illegal
ts' OO gh ee ch A	illegal
s I tL' o dz e	legal
z o b ee dz i	illegal
ts II t o ts' oo	legal
j a tL' o j aa	legal
dz aa d e ch I	illegal
z E dl o ch' i	illegal
s oo x a sh A	illegal
z I k AA j O	illegal
dz EE g O ch EE	illegal
ts A gh i sh aa	illegal
j aa m oo dz ee	illegal
ts' e k A ts' i	legal
ts' aa L z A	illegal
z II g i ch' aa	illegal
z O n e dz a	illegal
ts oo t' AA j ii	illegal
z a X oo zh ee	illegal
z ee x ee ts e	illegal
z ee gh EE z O	illegal
j o gh A ch oo	legal
z i t' A z II	illegal
ts e l e ts' A	legal
ts' a L e j oo	illegal
j o l ts' II	illegal
ch' II l oo z OO	illegal
ch' a g aa sh a	legal
ts' o g aa j ii	illegal
sh OO dl ee ch' oo	legal
s ii t EE z E	illegal
ts' A n AA ch O	illegal
j ee w II ch' II	legal
ts' oo t AA z ii	illegal
sh ii t' O z AA	illegal
ts aa t II ts' o	legal
j e k' z II	illegal
z o l oo ch' e	illegal
dz i k' ii ch o	illegal
sh AA m EE s AA	illegal
j i k' s a	illegal
s ee dl o z E	illegal
j o L oo z e	illegal
ts' EE t oo z o	illegal
j ii y ii s o	illegal
ch' EE k' AA ch a	legal
z O n ee z ee	illegal
ch e n aa ts ii	illegal
s ii y a sh e	illegal
ts I X EE z i	illegal
ts' A t' o s I	legal
ts I tL' ii zh o	illegal
sh aa L I z i	illegal
zh ii l a ch' EE	legal
dz oo t O ts' O	legal
ch' aa y ii zh ii	legal
z o w EE s e	illegal
ts oo d E z ii	illegal
zh EE l OO sh a	legal
ch ee d O ch ee	legal
j o d i sh oo	legal
ts' II x oo zh a	illegal
j II tL o s oo	illegal
sh A X o z oo	illegal
z a d A z A	illegal
z AA k E z A	illegal
sh OO x I zh O	legal
z O x o ts I	illegal
sh E g EE s AA	illegal
dz ee L a sh E	illegal
ch i d o ts I	illegal
ch' ee y OO dz II	illegal
ts' oo g o z aa	illegal
dz O X E dz ee	legal
ts' I l ts e	legal
z A m a z o	illegal
ch' aa g II j EE	legal
sh EE g a z o	illegal
sh e h i ch' ii	legal
j aa X I z E	illegal
ts' A k' aa z E	illegal
z i tL' EE dz ee	illegal
ts' e b a sh a	illegal
s II d I ts' aa	legal
ts' OO k A ts II	legal
ts e X aa j EE	illegal
z EE k i sh E	illegal
z AA w E j OO	illegal
ch' A k aa s ii	illegal
zh AA l a ch' o	legal
ch oo t' e ts' I	illegal
z EE m ii z A	illegal
ts' aa k ii s II	legal
z aa g EE j AA	illegal
j oo b O dz aa	illegal
dz o b a sh ii	illegal
ts OO h ii ts' o	legal
zh II m z ii	illegal
sh i gh OO z I	illegal
ch' ii k' OO sh EE	legal
zh I t' zh ii	legal
ch' II w oo z A	illegal
dz O w ee j E	illegal
zh OO dl zh E	legal
zh ii g E ts o	illegal
j e L ii j ii	legal
zh AA tL aa ts' I	illegal
sh aa tL dz O	illegal
z E g E ts' I	illegal
sh E t E z OO	illegal
ts OO k' OO ch' E	illegal
z e t' zh O	illegal
sh aa g ee z aa	illegal
ts ii dl II zh a	illegal
sh o gh I dz aa	illegal
ts' II gh oo sh ii	illegal
sh E tL' I dz I	illegal
ch' AA w I dz OO	illegal
z a k e ch' o	illegal
dz O g ii z a	illegal
ch' i d ii zh II	legal
z I k EE sh i	illegal
dz OO dl i dz o	legal
s oo g E zh A	illegal
dz a dl ts a	legal
z o x a ch' II	illegal
z ii dl II ch II	illegal
z o m O ch o	illegal
ch' ii t ii z E	illegal
j oo t ii ch' EE	legal
j O g A j O	legal
j a g I ts' aa	illegal
ts ii y E ch' aa	illegal
ts A L a zh oo	illegal
ts aa dl ts' AA	legal
sh ii x ii ch II	legal
dz A m z O	illegal
ts' O tL E z II	illegal
s aa h ee z I	illegal
s a L O ts' O	legal
z aa X O ts I	illegal
s AA gh s OO	legal
s AA k I zh e	illegal
ch o gh E sh E	legal
dz i b oo ch e	illegal
sh o L EE ts A	illegal
ch' OO X E sh a	legal
ts II t' ii s A	legal
ch A k' aa zh o	legal
dz O y EE ts' oo	legal
zh E y E ch oo	legal
z II l ch' O	illegal
z ee x E ch I	illegal
z O k a ts' oo	illegal
dz OO t A ch ii	illegal
j A gh EE s e	illegal
ts' EE l ee j ii	illegal
z o L a z I	illegal
ch e g e ts' ii	illegal
ts a t EE sh ee	illegal
z E t' ch O	illegal
zh aa n AA sh oo	legal
z ii h o ch ii	illegal
j A X II s o	illegal
j OO m EE z OO	illegal
dz O k' A z E	illegal
z I w AA ts I	illegal
sh a x e ts E	illegal
z A d i zh e	illegal
z ii t oo zh e	illegal
ts' I L II ch oo	illegal
j EE k' i z ii	illegal
ts' OO w oo ts I	legal
s EE t' AA ch oo	illegal
dz i g ii ch' E	illegal
sh ee l EE s e	illegal
s a b ii zh i	illegal
ts O t' E z AA	illegal
z EE gh O ts a	illegal
ch oo t' O ch' aa	legal
ch' E tL' a j o	legal
ch' ee m I zh II	legal
z II k I sh ee	illegal
z E dl e dz II	illegal
ch' ii h aa zh a	legal
ch II m OO ts' aa	illegal
s A d a dz i	legal
ch E tL EE ts' e	illegal
zh o x oo j OO	legal
ts OO m OO z i	illegal
z A t' AA sh OO	illegal
ch' oo X i dz I	illegal
ts' ii b sh AA	illegal
ch ii t' oo ch' E	legal
z o g i j EE	illegal
ch A dl O ts o	illegal
s i y aa z ee	illegal
z e n oo dz EE	illegal
dz OO L I ch' II	illegal
ts' O X o z AA	illegal
j a l O ch E	legal
z AA tL AA ts O	illegal
z o h AA sh a	illegal
ch EE b AA ts' i	illegal
z ee L i ch' E	illegal
z oo h OO zh e	illegal
ch' a x ch' ee	legal
s oo n ee ts OO	legal
ts aa X e z EE	illegal
sh a h I j aa	legal
s ee t E ch' e	illegal
s AA L II ts I	legal
j i x j ee	legal
ch' O gh o s i	illegal
ch ii m O s OO	illegal
ch' II h e ts E	illegal
ts' ee n o z ii	illegal
ch' aa tL' O zh e	legal
ch' e d e ch a	legal
ch OO tL aa j O	legal
ch' AA h AA z AA	illegal
zh ee t OO ts ii	illegal
ts' i x j oo	illegal
dz ii t E sh ee	illegal
ts i tL ee ts oo	legal
s II dl z O	illegal
ch' I gh ee s o	illegal
ts e h aa ts EE	legal
sh ii k A j e	legal
j OO n II z EE	illegal
zh EE t aa z I	illegal
zh EE m oo ts' i	illegal
ch OO k' o dz II	illegal
ts aa t o z oo	illegal
z A y ii zh o	illegal
ch A w i dz A	illegal
ts II h o s II	legal
j i dl II j OO	legal
dz i L oo ts' ee	legal
s i m EE z ee	illegal
ch' EE dl E sh II	legal
ch II b A s oo	illegal
dz E n ii j o	illegal
zh O l ii ch' OO	legal
s a n a ch o	illegal
ch A k ts' a	illegal
dz i h i s I	legal
s O m oo zh I	illegal
ch II n O z O	illegal
ch AA w ii ch e	legal
j II k' OO z II	illegal
ch AA l dz I	illegal
s e X aa z aa	illegal
ch' aa tL o j a	legal
z ee b I ch' E	illegal
ch' II b EE j O	legal
ch i h aa sh I	legal
dz ii dl E zh aa	illegal
z ee k dz ee	illegal
sh EE m dz o	illegal
ts' OO g oo z o	illegal
z ee l e sh ii	illegal
ts' I gh O sh e	illegal
ch' ee t' E dz E	illegal
zh a tL o ts' ii	illegal
j ii k I ch' ee	legal
ch O X EE ts o	illegal
zh e n EE ch AA	legal
s ee x a dz OO	legal
zh a k EE ch i	legal
j A n I ch A	legal
zh i k a sh EE	legal
ts' a gh AA zh e	illegal
j A dl OO ts' E	illegal
dz oo tL' e z OO	illegal
dz ii g i s oo	legal
zh oo t' a s O	illegal
ts' ii x e z A	illegal
ch' i tL' e ch' o	legal
z e d ee dz e	illegal
ts ee t' ee ch' ee	illegal
ch EE tL EE ch' oo	legal
ch e y A ts E	illegal
s e x II z E	illegal
zh A b o j aa	legal
dz O b II dz oo	legal
ch o gh aa dz a	illegal
dz E g II z a	illegal
s OO g oo z AA	illegal
ts' ii b II ch OO	illegal
zh ee gh e s aa	illegal
dz i y O z II	illegal
zh a y II sh oo	legal
s ii d s oo	legal
z AA k' o ts O	illegal
s AA w oo dz o	legal
ts' E dl II ch' O	illegal
ts i b OO s EE	legal
ts' i t oo dz e	legal
ts' i t e zh o	illegal
ts ii t' O ch' AA	illegal
j e m aa ch' O	legal
zh I y O sh e	legal
z o y OO sh e	illegal
ts ii h i ch' A	illegal
j aa m OO ts I	illegal
ch' i h OO z A	illegal
ts' oo gh i ch E	illegal
ts OO h E ts' O	legal
ts' E m o ch' e	illegal
ts II g ii j o	illegal
z a h a ch O	illegal
z a tL' aa z OO	illegal
sh ee tL AA sh AA	legal
j e t' A ch e	legal
j A gh ii ch A	legal
z a gh II ts o	illegal
z I g EE ch' E	illegal
ts oo X z o	illegal
dz a g A z EE	illegal
z a L e j o	illegal
ts' ii b oo j I	illegal
dz i tL e sh AA	illegal
ts aa g a ch O	illegal
z e X OO j a	illegal
ch' II k i ts EE	illegal
z a w E dz oo	illegal
s e g E ch aa	illegal
sh i k II ch' i	legal
ts' OO w i ts' e	legal
ch II h I ts OO	illegal
z II y E ts' ee	illegal
z oo tL' ee s e	illegal
z oo t' dz o	illegal
dz e m ee ts ee	legal
sh a x i z aa	illegal
ts' EE L I s oo	legal
z o x e dz ee	illegal
ts' a m aa j EE	illegal
dz OO tL ee ts I	legal
z EE L E s o	illegal
j A tL O s ee	illegal
zh i k I dz O	illegal
z ee dl z aa	illegal
ch ee k aa ch EE	legal
dz a b aa j EE	illegal
ch ii w II ch e	legal
ts' E g I ch i	illegal
s AA tL A s e	legal
ch ii w O ts aa	illegal
ch' II k' ch a	legal
zh e h oo ch' O	legal
zh o x z aa	illegal
j o tL' I ts' OO	illegal
z E m II j OO	illegal
sh E k' oo dz A	illegal
dz oo m i ch A	illegal
s O k' ii ch' o	illegal
z aa g OO z II	illegal
j AA L oo ts E	illegal
ch' II h I s I	illegal
sh A L I ts' ee	illegal
z oo d i ch' OO	illegal
z i t' AA ts O	illegal
z o m I ch E	illegal
ch' I tL E z i	illegal
ts I t I ch AA	illegal
ts' II t A ch' EE	illegal
dz AA x E dz a	legal
s a w A sh O	illegal
zh EE b ii j O	legal
ts II k I j o	illegal
dz I m oo zh EE	illegal
ch' ee dl j ii	legal
j oo k' ee j O	legal
ts e x aa sh E	illegal
ts' II x II ch ii	illegal
ch' I L OO ts' E	illegal
dz I t' ii zh E	illegal
z OO l E z ii	illegal
ts' I m OO j ii	illegal
j AA l EE zh AA	legal
j I k' z E	illegal
dz a t' ee ch' i	illegal
ts ii t' OO j AA	illegal
ch e k I dz EE	illegal
z aa n i sh O	illegal
ch' E x ee j ee	legal
sh A t' ii ch AA	legal
dz ee dl o z EE	illegal
j ii n O ts' EE	illegal
dz EE n ii s E	legal
ts oo L II ch' EE	illegal
sh o n a j A	legal
ts aa b aa j i	illegal
ch' OO tL' o sh oo	legal
z O X oo ch A	illegal
z I t o sh II	illegal
ts' ee X ii ts' AA	legal
dz II t' aa zh O	illegal
j A w ii z OO	illegal
j i k ee ts' A	illegal
ts AA g II ch O	illegal
ts' ii h EE z ee	illegal
sh aa x II z ii	illegal
s e dl EE z ee	illegal
ch' E d II z O	illegal
s O t i j ee	illegal
ts o g oo sh I	illegal
ts' i n A dz II	legal
dz ee n A dz ii	legal
zh ii t' AA dz O	illegal
sh i d s i	illegal
ch o t' AA ch' ii	legal
ts' OO m a dz OO	legal
ch O d II j I	legal
z AA w aa j AA	illegal
z OO x oo j E	illegal
ts I X i zh AA	illegal
sh e tL' e z A	illegal
z oo w II ch' aa	illegal
z ii g a s oo	illegal
s e d ch' AA	illegal
ts' I X O z ii	illegal
ch' AA t' oo sh i	legal
ch O X E z e	illegal
z o n EE ch EE	illegal
ch' I g e zh oo	legal
dz O l O ts ii	legal
ch OO L ch ii	legal
zh E b ee z ee	illegal
ch E b A j E	legal
z EE tL OO ts e	illegal
z oo tL' O sh E	illegal
z aa g o ts o	illegal
ch E w OO zh E	legal
ts' AA d OO sh a	illegal
ch ee L OO zh I	legal
z I tL i dz ee	illegal
ts ee n a ch II	illegal
ts' A w ee ts i	legal
s I dl i s ee	legal
s ee dl oo j O	illegal
z aa gh i s AA	illegal
dz EE k sh EE	illegal
ch' EE m aa dz I	illegal
z a L oo s i	illegal
ch' e x oo ch i	legal
sh OO k aa z e	illegal
dz aa g o zh A	illegal
zh E t i j II	legal
zh O w O ch' e	legal
ch' oo dl ee sh ii	legal
zh ee tL' a j II	legal
z ii tL' o j A	illegal
ch' a tL o z EE	illegal
ts' EE L s i	legal
dz aa l E z II	illegal
dz ii y ee dz I	legal
sh OO gh ee dz EE	illegal
s II y oo dz o	legal
z aa h i z II	illegal
z AA g j o	illegal
dz OO k a zh ee	illegal
ch' e w E zh o	legal
z ii y O ts O	illegal
sh II gh z OO	illegal
z O dl I s i	illegal
sh OO X ee ch aa	legal
ts' OO w O ts I	legal
zh A b oo ts' ii	illegal
sh e n AA ch' ii	legal
dz II gh OO ch' aa	illegal
ch' e gh A s aa	illegal
j II d i z i	illegal
s ee m A ts' aa	legal
ch II tL ii ts EE	illegal
sh ii y sh II	legal
ch' OO k' i z A	illegal
ch ee tL I dz EE	illegal
ch a k A s AA	illegal
s E n sh O	illegal
sh I X i ch' OO	legal
ts O n AA ts e	legal
ch' i gh I ts' ee	illegal
j aa w ii sh aa	legal
ts' O X AA zh II	illegal
z EE n I z OO	illegal
ch O b I dz AA	illegal
zh a tL' o ts OO	illegal
j O h I j OO	legal
z A y AA j e	illegal
zh oo gh I ts' E	illegal
ch' O l i sh ii	legal
ch' A t ii s aa	illegal
ch ee l e ts' aa	illegal
z A m ii j ii	illegal
sh II g II z e	illegal
z I L EE ts' a	illegal
ch OO t e sh ee	legal
s e l O z EE	illegal
ch o m ii dz aa	illegal
dz E t OO dz aa	legal
zh aa y ii zh A	legal
dz ee d OO zh OO	illegal
z ee t' E sh ee	illegal
ts' OO w E s A	legal
ts' o b OO zh ee	illegal
z OO tL e z I	illegal
ts' ee d a ch' e	illegal
zh O b e j OO	legal
j O h oo ts i	illegal
ch I tL ts' e	illegal
j EE n O ch OO	legal
ts' ee m i z e	illegal
ch A l AA ch' O	legal
j AA L ts aa	illegal
zh ee X ee sh e	legal
dz I n OO s o	legal
dz aa t i z A	illegal
dz aa X EE zh e	illegal
ts' EE tL II j E	illegal
j OO g OO dz E	illegal
z ii y z aa	illegal
j O L i j o	legal
s E m II ch' i	illegal
dz II tL' AA sh I	illegal
sh EE m EE zh AA	legal
j i tL' ee j o	legal
dz oo l e z i	illegal
ch' e g o j ee	legal
ch i L II z ee	illegal
ch aa w oo z E	illegal
z oo tL EE ch ee	illegal
zh i t o ts EE	illegal
sh EE n zh OO	legal
